frame_id,camera,local_track_id,global_id,x1,y1,x2,y2,width,height,center_x,center_y,confidence
0,broadcast,1,1,1423,741,1494,911,71,170,1458.5,826.0,0.8263508677482605
0,tacticam,1,9,314,526,366,590,52,64,340.0,558.0,0.9257323741912842
0,tacticam,2,15,1716,320,1748,383,32,63,1732.0,351.5,0.9226104021072388
0,tacticam,3,12,1133,480,1175,543,42,63,1154.0,511.5,0.9221810698509216
0,tacticam,4,20,928,197,967,247,39,50,947.5,222.0,0.9200133085250854
0,tacticam,5,2,901,573,942,639,41,66,921.5,606.0,0.9186127185821533
0,tacticam,6,22,1131,344,1168,403,37,59,1149.5,373.5,0.9177446365356445
0,tacticam,7,29,1659,461,1695,524,36,63,1677.0,492.5,0.9137505888938904
0,tacticam,8,8,1298,810,1329,889,31,79,1313.5,849.5,0.912670373916626
0,tacticam,9,21,361,377,391,433,30,56,376.0,405.0,0.9112020134925842
0,tacticam,10,3,342,804,377,878,35,74,359.5,841.0,0.910926342010498
0,tacticam,11,14,289,446,316,513,27,67,302.5,479.5,0.9100836515426636
0,tacticam,12,19,734,346,771,403,37,57,752.5,374.5,0.9099704623222351
0,tacticam,13,10,771,396,801,456,30,60,786.0,426.0,0.9091854691505432
0,tacticam,14,5,936,268,959,326,23,58,947.5,297.0,0.9076782464981079
0,tacticam,15,11,1026,147,1051,194,25,47,1038.5,170.5,0.9073315858840942
0,tacticam,16,4,848,237,890,289,42,52,869.0,263.0,0.9069505929946899
0,tacticam,17,31,446,211,482,266,36,55,464.0,238.5,0.9036909341812134
0,tacticam,18,7,1473,224,1504,272,31,48,1488.5,248.0,0.8906233906745911
0,tacticam,19,27,562,95,590,142,28,47,576.0,118.5,0.7681193947792053
0,tacticam,20,17,888,149,917,191,29,42,902.5,170.0,0.7430939674377441
0,tacticam,21,16,903,158,939,206,36,48,921.0,182.0,0.7301800847053528
1,broadcast,1,1,1426,675,1499,829,73,154,1462.5,752.0,0.776533305644989
1,tacticam,5,2,900,575,932,639,32,64,916.0,607.0,0.9258955121040344
1,tacticam,1,9,315,526,365,591,50,65,340.0,558.5,0.9255099892616272
1,tacticam,13,10,768,392,802,456,34,64,785.0,424.0,0.9231193661689758
1,tacticam,9,21,361,376,395,432,34,56,378.0,404.0,0.9188981056213379
1,tacticam,2,15,1712,320,1750,384,38,64,1731.0,352.0,0.9160159230232239
1,tacticam,17,31,445,209,480,265,35,56,462.5,237.0,0.9152284860610962
1,tacticam,3,12,1133,479,1173,543,40,64,1153.0,511.0,0.9151715636253357
1,tacticam,4,20,929,199,964,246,35,47,946.5,222.5,0.9148641228675842
1,tacticam,6,22,1130,345,1168,403,38,58,1149.0,374.0,0.9123653173446655
1,tacticam,7,29,1660,461,1698,524,38,63,1679.0,492.5,0.911170482635498
1,tacticam,12,19,732,346,771,402,39,56,751.5,374.0,0.9092860817909241
1,tacticam,11,14,289,446,316,512,27,66,302.5,479.0,0.9092201590538025
1,tacticam,10,3,338,802,375,878,37,76,356.5,840.0,0.9091663360595703
1,tacticam,16,4,847,239,885,290,38,51,866.0,264.5,0.9087154865264893
1,tacticam,18,7,1474,224,1504,272,30,48,1489.0,248.0,0.9035527110099792
1,tacticam,14,5,937,268,957,326,20,58,947.0,297.0,0.9025527834892273
1,tacticam,8,8,1303,810,1326,889,23,79,1314.5,849.5,0.8973841667175293
1,tacticam,15,11,1021,146,1044,195,23,49,1032.5,170.5,0.8081051111221313
1,tacticam,20,17,886,149,915,191,29,42,900.5,170.0,0.8003474473953247
1,tacticam,21,16,904,160,937,206,33,46,920.5,183.0,0.7898447513580322
1,tacticam,19,27,562,95,584,142,22,47,573.0,118.5,0.7795777916908264
1,tacticam,22,32,464,74,497,118,33,44,480.5,96.0,0.7993642687797546
2,broadcast,1,1,1369,663,1455,803,86,140,1412.0,733.0,0.7054756879806519
2,tacticam,13,10,766,396,804,455,38,59,785.0,425.5,0.9345380663871765
2,tacticam,17,31,443,208,482,265,39,57,462.5,236.5,0.9241502285003662
2,tacticam,10,3,333,800,379,876,46,76,356.0,838.0,0.9219365119934082
2,tacticam,2,15,1708,320,1753,383,45,63,1730.5,351.5,0.9217380285263062
2,tacticam,1,9,312,526,358,591,46,65,335.0,558.5,0.9207125902175903
2,tacticam,5,2,896,576,928,639,32,63,912.0,607.5,0.9142284989356995
2,tacticam,12,19,730,347,772,402,42,55,751.0,374.5,0.9131988286972046
2,tacticam,11,14,287,443,317,511,30,68,302.0,477.0,0.9130581617355347
2,tacticam,9,21,360,376,400,432,40,56,380.0,404.0,0.9124861359596252
2,tacticam,14,5,937,268,960,326,23,58,948.5,297.0,0.9098311066627502
2,tacticam,16,4,845,240,877,292,32,52,861.0,266.0,0.9088858962059021
2,tacticam,3,12,1134,481,1168,543,34,62,1151.0,512.0,0.908091127872467
2,tacticam,6,22,1133,347,1167,405,34,58,1150.0,376.0,0.907355010509491
2,tacticam,4,20,930,201,962,247,32,46,946.0,224.0,0.8978812098503113
2,tacticam,8,8,1304,810,1327,888,23,78,1315.5,849.0,0.8964030742645264
2,tacticam,7,29,1662,462,1699,524,37,62,1680.5,493.0,0.8946086168289185
2,tacticam,15,11,1019,145,1048,193,29,48,1033.5,169.0,0.8733455538749695
2,tacticam,18,7,1474,224,1501,273,27,49,1487.5,248.5,0.8643227815628052
2,tacticam,20,17,884,149,917,196,33,47,900.5,172.5,0.7991992831230164
2,tacticam,19,27,562,94,585,142,23,48,573.5,118.0,0.7646833062171936
2,tacticam,21,16,897,157,933,204,36,47,915.0,180.5,0.6533066034317017
3,tacticam,13,10,762,398,804,454,42,56,783.0,426.0,0.9358567595481873
3,tacticam,10,3,328,798,379,874,51,76,353.5,836.0,0.930526077747345
3,tacticam,17,31,439,206,484,263,45,57,461.5,234.5,0.9181755781173706
3,tacticam,2,15,1709,321,1753,384,44,63,1731.0,352.5,0.9171125888824463
3,tacticam,14,5,937,267,963,327,26,60,950.0,297.0,0.9158006906509399
3,tacticam,9,21,357,374,403,430,46,56,380.0,402.0,0.9152699112892151
3,tacticam,11,14,285,441,318,509,33,68,301.5,475.0,0.9147630929946899
3,tacticam,1,9,303,525,350,590,47,65,326.5,557.5,0.9134750962257385
3,tacticam,16,4,841,239,872,291,31,52,856.5,265.0,0.9128645658493042
3,tacticam,6,22,1135,348,1164,405,29,57,1149.5,376.5,0.9093217849731445
3,tacticam,3,12,1135,482,1163,543,28,61,1149.0,512.5,0.9084577560424805
3,tacticam,5,2,890,575,930,640,40,65,910.0,607.5,0.9079803228378296
3,tacticam,12,19,729,348,770,402,41,54,749.5,375.0,0.9065239429473877
3,tacticam,8,8,1301,810,1330,889,29,79,1315.5,849.5,0.9055455327033997
3,tacticam,15,11,1015,145,1046,193,31,48,1030.5,169.0,0.8928837776184082
3,tacticam,7,29,1664,462,1698,523,34,61,1681.0,492.5,0.8928825855255127
3,tacticam,4,20,929,202,957,247,28,45,943.0,224.5,0.8803099989891052
3,tacticam,18,7,1475,225,1501,272,26,47,1488.0,248.5,0.8782575726509094
3,tacticam,19,27,561,93,588,142,27,49,574.5,117.5,0.8671008944511414
3,tacticam,20,17,881,149,917,196,36,47,899.0,172.5,0.8353537917137146
4,tacticam,10,3,324,796,376,868,52,72,350.0,832.0,0.9339458346366882
4,tacticam,15,11,1013,144,1044,192,31,48,1028.5,168.0,0.9293978214263916
4,tacticam,14,5,934,267,966,327,32,60,950.0,297.0,0.9236404895782471
4,tacticam,1,9,300,525,344,589,44,64,322.0,557.0,0.9227716326713562
4,tacticam,16,4,837,240,874,289,37,49,855.5,264.5,0.9222687482833862
4,tacticam,11,14,285,440,320,505,35,65,302.5,472.5,0.9178240299224854
4,tacticam,5,2,885,574,931,638,46,64,908.0,606.0,0.9162906408309937
4,tacticam,8,8,1295,811,1334,889,39,78,1314.5,850.0,0.9137420654296875
4,tacticam,2,15,1711,322,1750,384,39,62,1730.5,353.0,0.9135016202926636
4,tacticam,13,10,763,398,800,454,37,56,781.5,426.0,0.9100577235221863
4,tacticam,18,7,1475,223,1504,272,29,49,1489.5,247.5,0.9080023765563965
4,tacticam,7,29,1662,462,1696,522,34,60,1679.0,492.0,0.9032033681869507
4,tacticam,3,12,1132,482,1156,543,24,61,1144.0,512.5,0.8981665372848511
4,tacticam,6,22,1134,348,1159,405,25,57,1146.5,376.5,0.894932746887207
4,tacticam,12,19,727,348,763,401,36,53,745.0,374.5,0.8918590545654297
4,tacticam,19,27,561,92,590,141,29,49,575.5,116.5,0.8905487656593323
4,tacticam,4,20,928,201,955,248,27,47,941.5,224.5,0.8846879005432129
4,tacticam,20,17,878,147,914,194,36,47,896.0,170.5,0.828235387802124
4,tacticam,22,32,456,71,494,118,38,47,475.0,94.5,0.7953000664710999
4,tacticam,21,16,901,158,926,206,25,48,913.5,182.0,0.7442489266395569
5,broadcast,2,2,1555,709,1640,840,85,131,1597.5,774.5,0.927844226360321
5,broadcast,3,3,599,752,659,886,60,134,629.0,819.0,0.9259259700775146
5,broadcast,4,4,1215,455,1279,549,64,94,1247.0,502.0,0.9126046299934387
5,broadcast,5,5,877,575,934,671,57,96,905.5,623.0,0.8988498449325562
5,broadcast,6,6,815,554,863,645,48,91,839.0,599.5,0.8970860838890076
5,broadcast,7,7,1650,440,1712,520,62,80,1681.0,480.0,0.8965871930122375
5,broadcast,8,8,1467,417,1515,502,48,85,1491.0,459.5,0.8898849487304688
5,broadcast,9,9,825,611,900,714,75,103,862.5,662.5,0.8886967897415161
5,broadcast,10,10,1730,588,1766,693,36,105,1748.0,640.5,0.8747303485870361
5,broadcast,11,11,1551,482,1607,578,56,96,1579.0,530.0,0.8710684776306152
5,broadcast,12,12,1568,556,1625,659,57,103,1596.5,607.5,0.8645504117012024
5,tacticam,16,4,834,241,874,289,40,48,854.0,265.0,0.9340078234672546
5,tacticam,14,5,932,266,967,327,35,61,949.5,296.5,0.9260110259056091
5,tacticam,11,14,286,438,319,502,33,64,302.5,470.0,0.924773633480072
5,tacticam,10,3,319,794,371,867,52,73,345.0,830.5,0.922968327999115
5,tacticam,15,11,1009,144,1043,193,34,49,1026.0,168.5,0.9224910736083984
5,tacticam,1,9,301,521,344,589,43,68,322.5,555.0,0.9180490374565125
5,tacticam,3,12,1128,481,1156,543,28,62,1142.0,512.0,0.9131163358688354
5,tacticam,5,2,877,574,928,637,51,63,902.5,605.5,0.9125289916992188
5,tacticam,18,7,1476,223,1507,273,31,50,1491.5,248.0,0.9117790460586548
5,tacticam,8,8,1292,811,1338,889,46,78,1315.0,850.0,0.911657989025116
5,tacticam,19,27,558,92,591,141,33,49,574.5,116.5,0.9112856984138489
5,tacticam,7,29,1664,462,1694,523,30,61,1679.0,492.5,0.9104856252670288
5,tacticam,13,10,763,398,796,456,33,58,779.5,427.0,0.9027307033538818
5,tacticam,12,19,726,348,758,400,32,52,742.0,374.0,0.8979568481445312
5,tacticam,6,22,1134,348,1156,405,22,57,1145.0,376.5,0.8891102075576782
5,tacticam,4,20,924,198,956,247,32,49,940.0,222.5,0.8641252517700195
5,tacticam,20,17,874,146,905,188,31,42,889.5,167.0,0.8086268901824951
5,tacticam,21,16,899,157,929,205,30,48,914.0,181.0,0.769623339176178
5,tacticam,22,32,457,70,494,118,37,48,475.5,94.0,0.7374551296234131
5,tacticam,2,15,1715,323,1743,383,28,60,1729.0,353.0,0.7252407073974609
6,broadcast,2,2,1550,711,1651,833,101,122,1600.5,772.0,0.9321438074111938
6,broadcast,9,9,833,617,899,719,66,102,866.0,668.0,0.9251099824905396
6,broadcast,6,6,807,557,867,659,60,102,837.0,608.0,0.9221330881118774
6,broadcast,3,3,602,751,668,879,66,128,635.0,815.0,0.9215946793556213
6,broadcast,5,5,883,575,949,671,66,96,916.0,623.0,0.9196915626525879
6,broadcast,4,4,1225,458,1273,551,48,93,1249.0,504.5,0.9058720469474792
6,broadcast,10,10,1736,589,1783,694,47,105,1759.5,641.5,0.9020271301269531
6,broadcast,12,12,1569,551,1639,660,70,109,1604.0,605.5,0.8801642656326294
6,broadcast,8,8,1469,419,1527,504,58,85,1498.0,461.5,0.8801535367965698
6,broadcast,11,11,1551,484,1616,575,65,91,1583.5,529.5,0.8687623739242554
6,tacticam,14,5,934,267,969,327,35,60,951.5,297.0,0.9273439645767212
6,tacticam,1,9,300,518,346,587,46,69,323.0,552.5,0.9256312251091003
6,tacticam,10,3,312,793,362,867,50,74,337.0,830.0,0.9208198189735413
6,tacticam,19,27,554,91,591,140,37,49,572.5,115.5,0.9187987446784973
6,tacticam,11,14,282,438,316,500,34,62,299.0,469.0,0.9181910157203674
6,tacticam,8,8,1293,812,1342,888,49,76,1317.5,850.0,0.9163919687271118
6,tacticam,15,11,1009,146,1042,194,33,48,1025.5,170.0,0.9160268306732178
6,tacticam,3,12,1125,480,1157,543,32,63,1141.0,511.5,0.9153013825416565
6,tacticam,18,7,1478,223,1509,272,31,49,1493.5,247.5,0.9130489230155945
6,tacticam,12,19,723,346,757,402,34,56,740.0,374.0,0.9080526828765869
6,tacticam,7,29,1664,461,1695,523,31,62,1679.5,492.0,0.905739426612854
6,tacticam,17,31,431,205,477,261,46,56,454.0,233.0,0.9055044054985046
6,tacticam,4,20,923,196,957,245,34,49,940.0,220.5,0.9012912511825562
6,tacticam,6,22,1132,347,1156,406,24,59,1144.0,376.5,0.8901358246803284
6,tacticam,13,10,763,398,786,455,23,57,774.5,426.5,0.8818519711494446
6,tacticam,21,16,898,156,930,203,32,47,914.0,179.5,0.8579731583595276
6,tacticam,20,17,868,147,901,189,33,42,884.5,168.0,0.8518863916397095
6,tacticam,22,32,461,69,497,119,36,50,479.0,94.0,0.6820402145385742
6,tacticam,2,15,1716,324,1741,383,25,59,1728.5,353.5,0.6627753973007202
7,broadcast,6,6,803,560,872,663,69,103,837.5,611.5,0.9265096187591553
7,broadcast,3,3,607,751,676,874,69,123,641.5,812.5,0.91718590259552
7,broadcast,7,7,1650,446,1712,525,62,79,1681.0,485.5,0.9086260199546814
7,broadcast,5,5,891,575,955,669,64,94,923.0,622.0,0.9060583710670471
7,broadcast,10,10,1742,590,1796,695,54,105,1769.0,642.5,0.9060087203979492
7,broadcast,9,9,838,615,893,724,55,109,865.5,669.5,0.9041571021080017
7,broadcast,4,4,1235,462,1280,553,45,91,1257.5,507.5,0.8957818150520325
7,broadcast,2,2,1546,713,1645,832,99,119,1595.5,772.5,0.8886674046516418
7,broadcast,12,12,1571,555,1649,658,78,103,1610.0,606.5,0.8768053650856018
7,broadcast,8,8,1474,424,1532,507,58,83,1503.0,465.5,0.8739987015724182
7,broadcast,11,11,1547,487,1595,581,48,94,1571.0,534.0,0.8709350824356079
7,broadcast,13,13,1547,713,1614,831,67,118,1580.5,772.0,0.9180934429168701
7,tacticam,1,9,299,516,347,585,48,69,323.0,550.5,0.9275910258293152
7,tacticam,11,14,279,437,314,499,35,62,296.5,468.0,0.925512433052063
7,tacticam,19,27,553,90,591,140,38,50,572.0,115.0,0.9220006465911865
7,tacticam,10,3,305,793,351,867,46,74,328.0,830.0,0.920640766620636
7,tacticam,3,12,1123,479,1157,542,34,63,1140.0,510.5,0.919843852519989
7,tacticam,14,5,938,267,968,327,30,60,953.0,297.0,0.91811203956604
7,tacticam,18,7,1479,223,1511,272,32,49,1495.0,247.5,0.9159286022186279
7,tacticam,16,4,827,242,867,294,40,52,847.0,268.0,0.9158141016960144
7,tacticam,8,8,1296,812,1345,890,49,78,1320.5,851.0,0.9153780937194824
7,tacticam,7,29,1664,460,1697,523,33,63,1680.5,491.5,0.9138597846031189
7,tacticam,17,31,431,205,466,263,35,58,448.5,234.0,0.9078947305679321
7,tacticam,12,19,722,344,757,400,35,56,739.5,372.0,0.907282829284668
7,tacticam,4,20,921,197,958,244,37,47,939.5,220.5,0.9068654775619507
7,tacticam,6,22,1131,347,1158,403,27,56,1144.5,375.0,0.9039391875267029
7,tacticam,5,2,871,576,921,640,50,64,896.0,608.0,0.9025492668151855
7,tacticam,2,15,1713,324,1737,383,24,59,1725.0,353.5,0.896094560623169
7,tacticam,20,17,868,148,893,191,25,43,880.5,169.5,0.8938360810279846
7,tacticam,15,11,1008,146,1035,195,27,49,1021.5,170.5,0.8933111429214478
7,tacticam,21,16,895,156,927,204,32,48,911.0,180.0,0.8898828625679016
7,tacticam,13,10,759,396,781,455,22,59,770.0,425.5,0.832187831401825
8,broadcast,10,10,1748,591,1809,696,61,105,1778.5,643.5,0.9243481159210205
8,broadcast,3,3,613,752,676,877,63,125,644.5,814.5,0.9185623526573181
8,broadcast,13,13,1540,718,1613,839,73,121,1576.5,778.5,0.9152621030807495
8,broadcast,5,5,898,578,951,666,53,88,924.5,622.0,0.9066061973571777
8,broadcast,4,4,1244,463,1295,558,51,95,1269.5,510.5,0.9052070379257202
8,broadcast,9,9,839,616,892,725,53,109,865.5,670.5,0.8900557160377502
8,broadcast,7,7,1662,450,1701,531,39,81,1681.5,490.5,0.8822416067123413
8,broadcast,8,8,1484,428,1530,513,46,85,1507.0,470.5,0.8654313683509827
8,broadcast,11,11,1552,490,1618,587,66,97,1585.0,538.5,0.8421838283538818
8,broadcast,14,14,808,565,876,666,68,101,842.0,615.5,0.9147713780403137
8,broadcast,15,15,0,505,41,610,41,105,20.5,557.5,0.6760829091072083
8,tacticam,3,12,1116,479,1158,542,42,63,1137.0,510.5,0.9303351640701294
8,tacticam,10,3,299,791,346,866,47,75,322.5,828.5,0.9301108121871948
8,tacticam,11,14,278,434,314,498,36,64,296.0,466.0,0.9270505905151367
8,tacticam,1,9,298,515,347,579,49,64,322.5,547.0,0.921419620513916
8,tacticam,7,29,1665,460,1699,524,34,64,1682.0,492.0,0.9190050959587097
8,tacticam,6,22,1130,347,1160,404,30,57,1145.0,375.5,0.9160401225090027
8,tacticam,8,8,1298,811,1348,889,50,78,1323.0,850.0,0.9156675338745117
8,tacticam,12,19,721,344,757,398,36,54,739.0,371.0,0.9139024019241333
8,tacticam,18,7,1479,223,1513,272,34,49,1496.0,247.5,0.9125922322273254
8,tacticam,2,15,1713,322,1739,384,26,62,1726.0,353.0,0.9118518829345703
8,tacticam,19,27,553,92,590,140,37,48,571.5,116.0,0.9089422225952148
8,tacticam,14,5,942,268,966,327,24,59,954.0,297.5,0.9066702127456665
8,tacticam,4,20,919,197,957,245,38,48,938.0,221.0,0.905966579914093
8,tacticam,17,31,429,204,463,262,34,58,446.0,233.0,0.9052282571792603
8,tacticam,13,10,754,394,783,454,29,60,768.5,424.0,0.8994963765144348
8,tacticam,5,2,868,576,912,640,44,64,890.0,608.0,0.8970863819122314
8,tacticam,15,11,1006,147,1029,195,23,48,1017.5,171.0,0.8947729468345642
8,tacticam,16,4,822,243,858,295,36,52,840.0,269.0,0.8930531144142151
8,tacticam,21,16,893,156,927,205,34,49,910.0,180.5,0.8924666047096252
8,tacticam,20,17,864,148,889,190,25,42,876.5,169.0,0.8834065794944763
9,broadcast,14,14,817,570,878,670,61,100,847.5,620.0,0.9069094657897949
9,broadcast,3,3,616,752,668,880,52,128,642.0,816.0,0.903045117855072
9,broadcast,7,7,1664,452,1699,534,35,82,1681.5,493.0,0.8992465734481812
9,broadcast,4,4,1250,464,1307,559,57,95,1278.5,511.5,0.8958069086074829
9,broadcast,5,5,897,577,956,665,59,88,926.5,621.0,0.8879802227020264
9,broadcast,12,12,1578,566,1640,664,62,98,1609.0,615.0,0.8872870802879333
9,broadcast,10,10,1755,594,1823,700,68,106,1789.0,647.0,0.8853731751441956
9,broadcast,9,9,844,613,897,727,53,114,870.5,670.0,0.8779076933860779
9,broadcast,8,8,1497,431,1531,515,34,84,1514.0,473.0,0.8660465478897095
9,broadcast,11,11,1563,497,1601,588,38,91,1582.0,542.5,0.8593044281005859
9,tacticam,10,3,297,789,347,865,50,76,322.0,827.0,0.9295868873596191
9,tacticam,3,12,1115,479,1156,543,41,64,1135.5,511.0,0.9276330471038818
9,tacticam,6,22,1126,347,1162,405,36,58,1144.0,376.0,0.9266200661659241
9,tacticam,8,8,1302,811,1348,889,46,78,1325.0,850.0,0.9228001832962036
9,tacticam,7,29,1663,460,1702,524,39,64,1682.5,492.0,0.921112060546875
9,tacticam,2,15,1710,322,1742,385,32,63,1726.0,353.5,0.9205734729766846
9,tacticam,11,14,281,431,316,497,35,66,298.5,464.0,0.9188441634178162
9,tacticam,16,4,818,243,850,296,32,53,834.0,269.5,0.9177762269973755
9,tacticam,1,9,298,515,344,579,46,64,321.0,547.0,0.9177291393280029
9,tacticam,12,19,718,342,756,397,38,55,737.0,369.5,0.9147394299507141
9,tacticam,19,27,557,95,589,141,32,46,573.0,118.0,0.9137499332427979
9,tacticam,18,7,1480,224,1513,274,33,50,1496.5,249.0,0.9061108231544495
9,tacticam,17,31,427,204,458,262,31,58,442.5,233.0,0.905754566192627
9,tacticam,15,11,1001,147,1032,195,31,48,1016.5,171.0,0.905035674571991
9,tacticam,14,5,944,268,964,327,20,59,954.0,297.5,0.9041632413864136
9,tacticam,5,2,862,574,902,640,40,66,882.0,607.0,0.90381920337677
9,tacticam,4,20,919,200,957,248,38,48,938.0,224.0,0.8975327610969543
9,tacticam,9,21,344,370,385,422,41,52,364.5,396.0,0.8971510529518127
9,tacticam,20,17,859,148,890,188,31,40,874.5,168.0,0.8961426615715027
9,tacticam,21,16,893,155,926,205,33,50,909.5,180.0,0.8930699825286865
9,tacticam,13,10,751,392,784,453,33,61,767.5,422.5,0.8898429274559021
10,broadcast,4,4,1255,466,1317,559,62,93,1286.0,512.5,0.919333279132843
10,broadcast,7,7,1661,452,1711,536,50,84,1686.0,494.0,0.9118945002555847
10,broadcast,2,2,1536,722,1631,847,95,125,1583.5,784.5,0.9116482734680176
10,broadcast,14,14,829,571,878,665,49,94,853.5,618.0,0.9004700779914856
10,broadcast,10,10,1762,593,1830,704,68,111,1796.0,648.5,0.9000867009162903
10,broadcast,8,8,1498,432,1538,518,40,86,1518.0,475.0,0.8985379338264465
10,broadcast,3,3,623,752,667,882,44,130,645.0,817.0,0.8944726586341858
10,broadcast,9,9,849,614,907,729,58,115,878.0,671.5,0.8819858431816101
10,broadcast,12,12,1586,569,1649,670,63,101,1617.5,619.5,0.8763935565948486
10,broadcast,5,5,920,578,959,670,39,92,939.5,624.0,0.8631173968315125
10,broadcast,11,11,1565,498,1596,589,31,91,1580.5,543.5,0.8630402684211731
10,tacticam,10,3,292,785,346,863,54,78,319.0,824.0,0.9354678988456726
10,tacticam,3,12,1116,480,1153,544,37,64,1134.5,512.0,0.928466260433197
10,tacticam,6,22,1124,348,1165,406,41,58,1144.5,377.0,0.9280955195426941
10,tacticam,8,8,1306,811,1346,888,40,77,1326.0,849.5,0.9249752759933472
10,tacticam,7,29,1663,461,1703,524,40,63,1683.0,492.5,0.9227073788642883
10,tacticam,16,4,816,242,851,295,35,53,833.5,268.5,0.9215947389602661
10,tacticam,15,11,999,146,1034,194,35,48,1016.5,170.0,0.9206873774528503
10,tacticam,2,15,1704,322,1744,386,40,64,1724.0,354.0,0.9170146584510803
10,tacticam,5,2,857,576,896,640,39,64,876.5,608.0,0.9146551489830017
10,tacticam,19,27,558,95,585,141,27,46,571.5,118.0,0.9122969508171082
10,tacticam,11,14,284,429,317,495,33,66,300.5,462.0,0.9118126630783081
10,tacticam,17,31,426,203,456,262,30,59,441.0,232.5,0.9079204201698303
10,tacticam,18,7,1480,226,1512,273,32,47,1496.0,249.5,0.9016060829162598
10,tacticam,12,19,716,343,753,397,37,54,734.5,370.0,0.8932712078094482
10,tacticam,1,9,297,514,326,579,29,65,311.5,546.5,0.8743371367454529
10,tacticam,4,20,922,200,952,248,30,48,937.0,224.0,0.8645999431610107
10,tacticam,21,16,893,156,921,205,28,49,907.0,180.5,0.8641746640205383
11,broadcast,8,8,1499,433,1547,519,48,86,1523.0,476.0,0.9268084168434143
11,broadcast,4,4,1258,466,1328,560,70,94,1293.0,513.0,0.9257209897041321
11,broadcast,2,2,1536,719,1625,846,89,127,1580.5,782.5,0.9157811999320984
11,broadcast,7,7,1655,452,1719,532,64,80,1687.0,492.0,0.9149947762489319
11,broadcast,10,10,1778,596,1834,704,56,108,1806.0,650.0,0.904672384262085
11,broadcast,14,14,834,570,879,662,45,92,856.5,616.0,0.9024192690849304
11,broadcast,3,3,628,749,672,878,44,129,650.0,813.5,0.8994535803794861
11,broadcast,11,11,1561,496,1596,576,35,80,1578.5,536.0,0.8947885632514954
11,broadcast,9,9,852,610,916,721,64,111,884.0,665.5,0.8939254283905029
11,broadcast,12,12,1592,566,1647,670,55,104,1619.5,618.0,0.8854153156280518
11,broadcast,5,5,933,574,966,672,33,98,949.5,623.0,0.8244457244873047
11,tacticam,10,3,290,781,346,856,56,75,318.0,818.5,0.9320755004882812
11,tacticam,15,11,997,146,1034,191,37,45,1015.5,168.5,0.923723042011261
11,tacticam,8,8,1309,809,1344,888,35,79,1326.5,848.5,0.9228048324584961
11,tacticam,6,22,1126,350,1165,408,39,58,1145.5,379.0,0.9220877885818481
11,tacticam,5,2,854,574,898,640,44,66,876.0,607.0,0.9216286540031433
11,tacticam,2,15,1702,322,1745,385,43,63,1723.5,353.5,0.9214362502098083
11,tacticam,7,29,1667,463,1703,524,36,61,1685.0,493.5,0.9213147163391113
11,tacticam,16,4,814,242,853,295,39,53,833.5,268.5,0.9188324809074402
11,tacticam,19,27,555,95,582,141,27,46,568.5,118.0,0.9154088497161865
11,tacticam,17,31,424,200,459,261,35,61,441.5,230.5,0.9120630025863647
11,tacticam,11,14,286,425,318,491,32,66,302.0,458.0,0.9118838906288147
11,tacticam,3,12,1120,481,1147,543,27,62,1133.5,512.0,0.8985835313796997
11,tacticam,13,10,745,392,785,450,40,58,765.0,421.0,0.8965693712234497
11,tacticam,18,7,1481,226,1510,274,29,48,1495.5,250.0,0.8934602737426758
11,tacticam,12,19,718,343,753,399,35,56,735.5,371.0,0.8924532532691956
11,tacticam,1,9,298,513,326,579,28,66,312.0,546.0,0.8847327828407288
11,tacticam,14,5,946,267,966,327,20,60,956.0,297.0,0.873697817325592
11,tacticam,21,16,892,157,917,204,25,47,904.5,180.5,0.8673578500747681
11,tacticam,4,20,921,200,948,248,27,48,934.5,224.0,0.8522619605064392
12,broadcast,2,2,1534,717,1635,843,101,126,1584.5,780.0,0.9292099475860596
12,broadcast,3,3,632,745,686,878,54,133,659.0,811.5,0.9163651466369629
12,broadcast,4,4,1266,469,1336,561,70,92,1301.0,515.0,0.9101171493530273
12,broadcast,9,9,853,609,926,717,73,108,889.5,663.0,0.9086828827857971
12,broadcast,14,14,827,568,881,662,54,94,854.0,615.0,0.9081701636314392
12,broadcast,8,8,1503,430,1552,518,49,88,1527.5,474.0,0.9051020741462708
12,broadcast,5,5,937,571,981,671,44,100,959.0,621.0,0.896530270576477
12,broadcast,10,10,1788,597,1834,705,46,108,1811.0,651.0,0.8921337723731995
12,broadcast,11,11,1557,495,1610,585,53,90,1583.5,540.0,0.8898547291755676
12,broadcast,12,12,1596,567,1641,671,45,104,1618.5,619.0,0.881861686706543
12,tacticam,17,31,422,200,462,257,40,57,442.0,228.5,0.9258177876472473
12,tacticam,10,3,289,779,343,852,54,73,316.0,815.5,0.9256453514099121
12,tacticam,5,2,854,571,898,639,44,68,876.0,605.0,0.9244459271430969
12,tacticam,11,14,287,424,320,487,33,63,303.5,455.5,0.9167320728302002
12,tacticam,7,29,1669,464,1702,524,33,60,1685.5,494.0,0.915583610534668
12,tacticam,15,11,995,145,1032,192,37,47,1013.5,168.5,0.9151819348335266
12,tacticam,2,15,1703,323,1746,386,43,63,1724.5,354.5,0.9143943190574646
12,tacticam,6,22,1129,351,1163,408,34,57,1146.0,379.5,0.9135599732398987
12,tacticam,19,27,554,95,580,140,26,45,567.0,117.5,0.9114711284637451
12,tacticam,8,8,1314,809,1342,886,28,77,1328.0,847.5,0.9107665419578552
12,tacticam,1,9,298,513,327,578,29,65,312.5,545.5,0.9067622423171997
12,tacticam,18,7,1482,226,1509,273,27,47,1495.5,249.5,0.8949946165084839
12,tacticam,12,19,717,344,746,398,29,54,731.5,371.0,0.8896351456642151
12,tacticam,4,20,919,198,944,247,25,49,931.5,222.5,0.8874247670173645
12,tacticam,14,5,946,267,970,327,24,60,958.0,297.0,0.8818087577819824
12,tacticam,3,12,1116,481,1142,543,26,62,1129.0,512.0,0.881126344203949
12,tacticam,21,16,889,155,918,200,29,45,903.5,177.5,0.8620367646217346
12,tacticam,13,10,748,393,779,452,31,59,763.5,422.5,0.8021494150161743
13,broadcast,3,3,635,743,693,865,58,122,664.0,804.0,0.9195693731307983
13,broadcast,8,8,1502,431,1554,517,52,86,1528.0,474.0,0.9119760394096375
13,broadcast,7,7,1651,453,1716,535,65,82,1683.5,494.0,0.9057159423828125
13,broadcast,4,4,1268,471,1339,564,71,93,1303.5,517.5,0.8945671916007996
13,broadcast,11,11,1551,494,1622,587,71,93,1586.5,540.5,0.8940699100494385
13,broadcast,9,9,857,606,927,717,70,111,892.0,661.5,0.8922492265701294
13,broadcast,14,14,825,568,894,661,69,93,859.5,614.5,0.8876497745513916
13,broadcast,5,5,939,569,985,661,46,92,962.0,615.0,0.8820713758468628
13,broadcast,12,12,1598,563,1652,673,54,110,1625.0,618.0,0.8797518610954285
13,broadcast,15,15,73,508,110,614,37,106,91.5,561.0,0.8216111660003662
13,broadcast,10,10,1796,598,1841,706,45,108,1818.5,652.0,0.7855560183525085
13,tacticam,5,2,846,573,899,638,53,65,872.5,605.5,0.9240931272506714
13,tacticam,14,5,943,265,975,327,32,62,959.0,296.0,0.9231675863265991
13,tacticam,17,31,420,200,462,256,42,56,441.0,228.0,0.9188739657402039
13,tacticam,10,3,289,779,333,852,44,73,311.0,815.5,0.9170371890068054
13,tacticam,16,4,807,243,846,295,39,52,826.5,269.0,0.9170117378234863
13,tacticam,19,27,554,95,582,139,28,44,568.0,117.0,0.9151022434234619
13,tacticam,4,20,918,199,946,247,28,48,932.0,223.0,0.9147354364395142
13,tacticam,11,14,288,424,319,484,31,60,303.5,454.0,0.9129465818405151
13,tacticam,7,29,1670,464,1699,525,29,61,1684.5,494.5,0.9103199243545532
13,tacticam,1,9,296,512,331,577,35,65,313.5,544.5,0.9086474776268005
13,tacticam,6,22,1132,353,1160,409,28,56,1146.0,381.0,0.9027941823005676
13,tacticam,18,7,1483,226,1510,275,27,49,1496.5,250.5,0.9018580913543701
13,tacticam,2,15,1707,325,1743,388,36,63,1725.0,356.5,0.8992719054222107
13,tacticam,15,11,993,146,1028,194,35,48,1010.5,170.0,0.8982083201408386
13,tacticam,8,8,1315,808,1339,885,24,77,1327.0,846.5,0.8980317711830139
13,tacticam,3,12,1115,482,1140,543,25,61,1127.5,512.5,0.8866649866104126
13,tacticam,12,19,716,343,740,398,24,55,728.0,370.5,0.8841244578361511
13,tacticam,21,16,887,155,920,203,33,48,903.5,179.0,0.8805906772613525
13,tacticam,13,10,748,394,770,451,22,57,759.0,422.5,0.8176259994506836
14,broadcast,8,8,1504,433,1553,518,49,85,1528.5,475.5,0.9148639440536499
14,broadcast,3,3,637,741,694,863,57,122,665.5,802.0,0.9083868265151978
14,broadcast,12,12,1598,555,1664,673,66,118,1631.0,614.0,0.905080258846283
14,broadcast,9,9,859,605,917,720,58,115,888.0,662.5,0.8996824622154236
14,broadcast,5,5,948,566,987,660,39,94,967.5,613.0,0.895504891872406
14,broadcast,4,4,1268,472,1340,565,72,93,1304.0,518.5,0.894132673740387
14,broadcast,14,14,830,568,893,665,63,97,861.5,616.5,0.8881990313529968
14,broadcast,10,10,1805,595,1853,705,48,110,1829.0,650.0,0.8833461999893188
14,broadcast,7,7,1664,454,1697,537,33,83,1680.5,495.5,0.8618969917297363
14,broadcast,15,15,86,509,124,614,38,105,105.0,561.5,0.8479799628257751
14,tacticam,14,5,943,266,979,327,36,61,961.0,296.5,0.9209043383598328
14,tacticam,20,17,841,149,866,191,25,42,853.5,170.0,0.9195619225502014
14,tacticam,1,9,293,510,334,576,41,66,313.5,543.0,0.9192723035812378
14,tacticam,19,27,554,94,585,143,31,49,569.5,118.5,0.9190560579299927
14,tacticam,10,3,286,777,323,852,37,75,304.5,814.5,0.9177761673927307
14,tacticam,18,7,1485,226,1514,275,29,49,1499.5,250.5,0.9148707389831543
14,tacticam,7,29,1670,464,1696,525,26,61,1683.0,494.5,0.9144835472106934
14,tacticam,5,2,844,573,895,637,51,64,869.5,605.0,0.9142740368843079
14,tacticam,16,4,804,244,840,298,36,54,822.0,271.0,0.9126001000404358
14,tacticam,17,31,416,200,462,256,46,56,439.0,228.0,0.9121770262718201
14,tacticam,4,20,917,198,950,246,33,48,933.5,222.0,0.9117721915245056
14,tacticam,11,14,290,423,318,482,28,59,304.0,452.5,0.9117463231086731
14,tacticam,3,12,1112,481,1144,543,32,62,1128.0,512.0,0.9108847379684448
14,tacticam,21,16,887,155,922,203,35,48,904.5,179.0,0.9075730443000793
14,tacticam,8,8,1315,807,1339,886,24,79,1327.0,846.5,0.9056404829025269
14,tacticam,2,15,1712,326,1738,387,26,61,1725.0,356.5,0.901500403881073
14,tacticam,6,22,1133,352,1155,408,22,56,1144.0,380.0,0.8950538039207458
14,tacticam,12,19,714,343,742,398,28,55,728.0,370.5,0.884183406829834
14,tacticam,13,10,748,394,773,453,25,59,760.5,423.5,0.8699451684951782
14,tacticam,15,11,993,147,1022,195,29,48,1007.5,171.0,0.852229654788971
15,broadcast,12,12,1598,560,1672,665,74,105,1635.0,612.5,0.9142580032348633
15,broadcast,4,4,1270,473,1338,564,68,91,1304.0,518.5,0.9120939373970032
15,broadcast,3,3,637,739,690,866,53,127,663.5,802.5,0.9060649275779724
15,broadcast,7,7,1663,454,1700,536,37,82,1681.5,495.0,0.9040575623512268
15,broadcast,14,14,837,568,894,665,57,97,865.5,616.5,0.8985529541969299
15,broadcast,8,8,1511,434,1554,522,43,88,1532.5,478.0,0.8949671983718872
15,broadcast,11,11,1555,494,1624,584,69,90,1589.5,539.0,0.889584481716156
15,broadcast,5,5,956,565,998,660,42,95,977.0,612.5,0.8855148553848267
15,broadcast,9,9,863,610,914,719,51,109,888.5,664.5,0.882001519203186
15,broadcast,10,10,1811,595,1861,704,50,109,1836.0,649.5,0.8472074270248413
15,tacticam,14,5,947,267,982,328,35,61,964.5,297.5,0.9260643124580383
15,tacticam,1,9,290,507,337,573,47,66,313.5,540.0,0.9236038327217102
15,tacticam,20,17,839,148,868,191,29,43,853.5,169.5,0.9231374263763428
15,tacticam,11,14,293,423,320,482,27,59,306.5,452.5,0.9211695194244385
15,tacticam,19,27,556,93,589,143,33,50,572.5,118.0,0.91843181848526
15,tacticam,7,29,1671,463,1699,526,28,63,1685.0,494.5,0.9178224205970764
15,tacticam,21,16,886,155,924,204,38,49,905.0,179.5,0.9167113304138184
15,tacticam,3,12,1112,480,1145,542,33,62,1128.5,511.0,0.9165073037147522
15,tacticam,4,20,916,198,951,246,35,48,933.5,222.0,0.9159181118011475
15,tacticam,18,7,1486,226,1517,276,31,50,1501.5,251.0,0.9141376614570618
15,tacticam,10,3,284,776,319,848,35,72,301.5,812.0,0.9112881422042847
15,tacticam,5,2,846,574,889,639,43,65,867.5,606.5,0.9089453816413879
15,tacticam,8,8,1315,807,1343,887,28,80,1329.0,847.0,0.9074124693870544
15,tacticam,9,21,336,364,377,417,41,53,356.5,390.5,0.8941156268119812
15,tacticam,15,11,991,147,1017,195,26,48,1004.0,171.0,0.8938742876052856
15,tacticam,12,19,712,343,745,398,33,55,728.5,370.5,0.8933513760566711
15,tacticam,6,22,1133,351,1154,408,21,57,1143.5,379.5,0.8925064206123352
15,tacticam,2,15,1712,326,1735,387,23,61,1723.5,356.5,0.8918723464012146
15,tacticam,13,10,745,390,773,454,28,64,759.0,422.0,0.8910529017448425
15,tacticam,16,4,803,246,829,297,26,51,816.0,271.5,0.7925609946250916
16,broadcast,2,2,1534,716,1629,837,95,121,1581.5,776.5,0.9337530732154846
16,broadcast,12,12,1597,561,1677,662,80,101,1637.0,611.5,0.912532389163971
16,broadcast,3,3,642,737,690,864,48,127,666.0,800.5,0.9053406715393066
16,broadcast,4,4,1278,473,1336,564,58,91,1307.0,518.5,0.9028856754302979
16,broadcast,7,7,1658,452,1713,537,55,85,1685.5,494.5,0.9025894999504089
16,broadcast,14,14,837,568,898,665,61,97,867.5,616.5,0.897822916507721
16,broadcast,8,8,1522,437,1557,524,35,87,1539.5,480.5,0.8934484720230103
16,broadcast,5,5,962,563,1008,661,46,98,985.0,612.0,0.8851003646850586
16,broadcast,10,10,1812,593,1871,701,59,108,1841.5,647.0,0.8767308592796326
16,broadcast,9,9,870,615,910,719,40,104,890.0,667.0,0.8650020956993103
16,broadcast,11,11,1562,494,1615,590,53,96,1588.5,542.0,0.8614659905433655
16,tacticam,10,3,280,771,323,847,43,76,301.5,809.0,0.9311134815216064
16,tacticam,14,5,951,268,986,328,35,60,968.5,298.0,0.9240044951438904
16,tacticam,7,29,1671,462,1702,525,31,63,1686.5,493.5,0.9226747155189514
16,tacticam,1,9,290,505,337,569,47,64,313.5,537.0,0.9223294258117676
16,tacticam,11,14,294,420,324,481,30,61,309.0,450.5,0.9208300709724426
16,tacticam,18,7,1487,226,1520,276,33,50,1503.5,251.0,0.915708601474762
16,tacticam,4,20,915,199,952,246,37,47,933.5,222.5,0.9156062006950378
16,tacticam,13,10,742,384,774,450,32,66,758.0,417.0,0.9155629873275757
16,tacticam,3,12,1110,480,1148,541,38,61,1129.0,510.5,0.913019061088562
16,tacticam,8,8,1313,808,1348,886,35,78,1330.5,847.0,0.9116256833076477
16,tacticam,17,31,417,201,462,258,45,57,439.5,229.5,0.9098731279373169
16,tacticam,6,22,1134,351,1159,408,25,57,1146.5,379.5,0.9090330600738525
16,tacticam,19,27,557,94,589,144,32,50,573.0,119.0,0.9079358577728271
16,tacticam,12,19,710,340,746,397,36,57,728.0,368.5,0.9054986238479614
16,tacticam,9,21,335,364,369,417,34,53,352.0,390.5,0.905454158782959
16,tacticam,5,2,843,573,878,639,35,66,860.5,606.0,0.9023978114128113
16,tacticam,21,16,887,155,924,205,37,50,905.5,180.0,0.9022560119628906
16,tacticam,16,4,800,246,831,298,31,52,815.5,272.0,0.8984823822975159
16,tacticam,15,11,991,148,1020,193,29,45,1005.5,170.5,0.8979907035827637
16,tacticam,2,15,1711,325,1735,388,24,63,1723.0,356.5,0.8934884071350098
17,broadcast,2,2,1534,715,1619,840,85,125,1576.5,777.5,0.9387239217758179
17,broadcast,7,7,1655,452,1717,532,62,80,1686.0,492.0,0.9141627550125122
17,broadcast,3,3,645,733,698,862,53,129,671.5,797.5,0.9140649437904358
17,broadcast,12,12,1603,560,1661,664,58,104,1632.0,612.0,0.9053114056587219
17,broadcast,14,14,845,565,899,638,54,73,872.0,601.5,0.9048373103141785
17,broadcast,8,8,1518,436,1561,526,43,90,1539.5,481.0,0.9018835425376892
17,broadcast,9,9,871,614,919,720,48,106,895.0,667.0,0.8883172273635864
17,broadcast,10,10,1819,593,1879,699,60,106,1849.0,646.0,0.8816219568252563
17,broadcast,5,5,970,561,1023,658,53,97,996.5,609.5,0.8750506043434143
17,broadcast,11,11,1566,494,1602,588,36,94,1584.0,541.0,0.8649857640266418
17,broadcast,4,4,1281,471,1336,545,55,74,1308.5,508.0,0.7803244590759277
17,broadcast,16,16,1308,492,1350,563,42,71,1329.0,527.5,0.8487309217453003
17,tacticam,10,3,277,768,326,844,49,76,301.5,806.0,0.9382218718528748
17,tacticam,13,10,741,384,778,449,37,65,759.5,416.5,0.9266690611839294
17,tacticam,6,22,1134,350,1163,408,29,58,1148.5,379.0,0.9232043623924255
17,tacticam,8,8,1310,808,1352,885,42,77,1331.0,846.5,0.923095703125
17,tacticam,7,29,1672,463,1706,526,34,63,1689.0,494.5,0.9227747917175293
17,tacticam,4,20,918,201,950,248,32,47,934.0,224.5,0.9204753041267395
17,tacticam,9,21,335,364,372,417,37,53,353.5,390.5,0.9175983667373657
17,tacticam,3,12,1109,480,1146,542,37,62,1127.5,511.0,0.9154551029205322
17,tacticam,2,15,1711,325,1740,388,29,63,1725.5,356.5,0.9141793847084045
17,tacticam,18,7,1487,227,1522,278,35,51,1504.5,252.5,0.9140501022338867
17,tacticam,11,14,296,418,332,478,36,60,314.0,448.0,0.9136098027229309
17,tacticam,14,5,957,271,989,327,32,56,973.0,299.0,0.9131556153297424
17,tacticam,1,9,292,504,334,567,42,63,313.0,535.5,0.9107275009155273
17,tacticam,17,31,417,201,460,258,43,57,438.5,229.5,0.9091794490814209
17,tacticam,16,4,796,245,835,295,39,50,815.5,270.0,0.9076766967773438
17,tacticam,15,11,990,148,1023,193,33,45,1006.5,170.5,0.905897319316864
17,tacticam,19,27,560,97,592,155,32,58,576.0,126.0,0.9044522047042847
17,tacticam,12,19,709,340,747,396,38,56,728.0,368.0,0.9037591218948364
17,tacticam,5,2,841,573,871,638,30,65,856.0,605.5,0.9032226204872131
17,tacticam,21,16,890,157,920,206,30,49,905.0,181.5,0.8914195895195007
18,broadcast,2,2,1537,712,1611,840,74,128,1574.0,776.0,0.9315915107727051
18,broadcast,3,3,650,729,707,860,57,131,678.5,794.5,0.9164716601371765
18,broadcast,14,14,851,563,903,641,52,78,877.0,602.0,0.9117745757102966
18,broadcast,16,16,1290,471,1361,563,71,92,1325.5,517.0,0.9044828414916992
18,broadcast,8,8,1512,437,1569,523,57,86,1540.5,480.0,0.9001082181930542
18,broadcast,5,5,975,559,1028,654,53,95,1001.5,606.5,0.9000076651573181
18,broadcast,9,9,872,610,927,718,55,108,899.5,664.0,0.898621678352356
18,broadcast,11,11,1567,491,1607,588,40,97,1587.0,539.5,0.8820083141326904
18,broadcast,12,12,1610,562,1657,667,47,105,1633.5,614.5,0.8765051364898682
18,broadcast,10,10,1831,594,1885,699,54,105,1858.0,646.5,0.8514291048049927
18,tacticam,10,3,275,765,327,836,52,71,301.0,800.5,0.9385083317756653
18,tacticam,8,8,1309,808,1357,885,48,77,1333.0,846.5,0.9357806444168091
18,tacticam,11,14,298,415,337,476,39,61,317.5,445.5,0.9288868308067322
18,tacticam,13,10,739,387,781,447,42,60,760.0,417.0,0.9280857443809509
18,tacticam,7,29,1670,463,1710,526,40,63,1690.0,494.5,0.9251384735107422
18,tacticam,6,22,1133,351,1166,410,33,59,1149.5,380.5,0.9209854602813721
18,tacticam,20,17,829,148,864,190,35,42,846.5,169.0,0.9202430248260498
18,tacticam,1,9,289,504,330,567,41,63,309.5,535.5,0.9154239296913147
18,tacticam,18,7,1489,229,1524,280,35,51,1506.5,254.5,0.9118965268135071
18,tacticam,2,15,1706,325,1743,389,37,64,1724.5,357.0,0.9117301106452942
18,tacticam,5,2,839,572,875,639,36,67,857.0,605.5,0.9111440181732178
18,tacticam,3,12,1111,481,1144,544,33,63,1127.5,512.5,0.9100615382194519
18,tacticam,19,27,564,99,591,157,27,58,577.5,128.0,0.9087181687355042
18,tacticam,14,5,962,271,989,327,27,56,975.5,299.0,0.9072368144989014
18,tacticam,4,20,920,201,948,250,28,49,934.0,225.5,0.9056758880615234
18,tacticam,12,19,707,341,746,397,39,56,726.5,369.0,0.9005487561225891
18,tacticam,17,31,416,201,457,258,41,57,436.5,229.5,0.898622453212738
18,tacticam,21,16,890,158,916,205,26,47,903.0,181.5,0.8750540614128113
19,broadcast,2,2,1541,709,1623,840,82,131,1582.0,774.5,0.9379031658172607
19,broadcast,3,3,653,728,715,850,62,122,684.0,789.0,0.9253471493721008
19,broadcast,16,16,1295,470,1371,562,76,92,1333.0,516.0,0.9167843461036682
19,broadcast,14,14,857,561,907,645,50,84,882.0,603.0,0.9093117117881775
19,broadcast,9,9,872,610,938,711,66,101,905.0,660.5,0.9044935703277588
19,broadcast,5,5,981,558,1030,649,49,91,1005.5,603.5,0.9024990797042847
19,broadcast,8,8,1513,437,1575,524,62,87,1544.0,480.5,0.9022355675697327
19,broadcast,7,7,1651,451,1708,534,57,83,1679.5,492.5,0.8991410136222839
19,broadcast,11,11,1562,487,1613,579,51,92,1587.5,533.0,0.8986570835113525
19,broadcast,12,12,1616,564,1650,668,34,104,1633.0,616.0,0.8429867029190063
19,broadcast,10,10,1845,594,1888,701,43,107,1866.5,647.5,0.8096364736557007
19,tacticam,11,14,301,414,340,472,39,58,320.5,443.0,0.930877685546875
19,tacticam,10,3,276,764,323,832,47,68,299.5,798.0,0.9304081201553345
19,tacticam,13,10,739,390,781,446,42,56,760.0,418.0,0.9281662702560425
19,tacticam,5,2,835,570,877,637,42,67,856.0,603.5,0.9264150857925415
19,tacticam,8,8,1313,808,1360,884,47,76,1336.5,846.0,0.9224854111671448
19,tacticam,7,29,1668,463,1711,527,43,64,1689.5,495.0,0.9208164811134338
19,tacticam,6,22,1131,352,1168,412,37,60,1149.5,382.0,0.9180022478103638
19,tacticam,20,17,829,150,859,192,30,42,844.0,171.0,0.9176482558250427
19,tacticam,2,15,1702,326,1745,390,43,64,1723.5,358.0,0.9163180589675903
19,tacticam,1,9,291,503,327,567,36,64,309.0,535.0,0.9124274253845215
19,tacticam,12,19,711,343,749,398,38,55,730.0,370.5,0.9094096422195435
19,tacticam,17,31,418,200,452,258,34,58,435.0,229.0,0.9048598408699036
19,tacticam,14,5,968,270,989,328,21,58,978.5,299.0,0.9009249806404114
19,tacticam,19,27,567,101,592,156,25,55,579.5,128.5,0.9007455110549927
19,tacticam,4,20,920,203,945,249,25,46,932.5,226.0,0.8946793079376221
19,tacticam,18,7,1492,231,1521,281,29,50,1506.5,256.0,0.8929365873336792
19,tacticam,3,12,1114,482,1141,543,27,61,1127.5,512.5,0.8928400278091431
19,tacticam,21,16,890,158,917,205,27,47,903.5,181.5,0.870642900466919
20,broadcast,2,2,1543,707,1634,834,91,127,1588.5,770.5,0.9300705790519714
20,broadcast,9,9,866,609,944,712,78,103,905.0,660.5,0.9204027652740479
20,broadcast,3,3,655,722,720,843,65,121,687.5,782.5,0.9202543497085571
20,broadcast,8,8,1514,438,1573,525,59,87,1543.5,481.5,0.9090508222579956
20,broadcast,5,5,986,557,1039,653,53,96,1012.5,605.0,0.908004105091095
20,broadcast,11,11,1557,488,1620,577,63,89,1588.5,532.5,0.9053726196289062
20,broadcast,14,14,857,559,913,648,56,89,885.0,603.5,0.901353120803833
20,broadcast,7,7,1663,452,1693,535,30,83,1678.0,493.5,0.862983763217926
20,broadcast,10,10,1850,595,1889,702,39,107,1869.5,648.5,0.8446149826049805
20,broadcast,12,12,1617,562,1661,660,44,98,1639.0,611.0,0.8075897693634033
20,tacticam,11,14,305,413,342,468,37,55,323.5,440.5,0.9304820895195007
20,tacticam,8,8,1318,808,1366,883,48,75,1342.0,845.5,0.9230756759643555
20,tacticam,2,15,1700,327,1747,389,47,62,1723.5,358.0,0.922024667263031
20,tacticam,17,31,421,199,456,258,35,59,438.5,228.5,0.9195833802223206
20,tacticam,13,10,743,391,781,447,38,56,762.0,419.0,0.9159978032112122
20,tacticam,7,29,1671,464,1711,527,40,63,1691.0,495.5,0.9158747792243958
20,tacticam,16,4,786,247,826,299,40,52,806.0,273.0,0.9147238731384277
20,tacticam,6,22,1132,355,1168,413,36,58,1150.0,384.0,0.914132297039032
20,tacticam,10,3,272,760,315,831,43,71,293.5,795.5,0.9116793870925903
20,tacticam,12,19,710,344,747,398,37,54,728.5,371.0,0.9089046120643616
20,tacticam,1,9,291,500,328,565,37,65,309.5,532.5,0.9088929295539856
20,tacticam,15,11,986,152,1018,198,32,46,1002.0,175.0,0.9071891903877258
20,tacticam,19,27,569,103,593,154,24,51,581.0,128.5,0.9054452776908875
20,tacticam,18,7,1493,233,1520,283,27,50,1506.5,258.0,0.8887510895729065
20,tacticam,21,16,890,158,920,205,30,47,905.0,181.5,0.8874355554580688
20,tacticam,3,12,1113,483,1136,542,23,59,1124.5,512.5,0.8766169548034668
20,tacticam,4,20,920,205,945,250,25,45,932.5,227.5,0.8646143674850464
21,broadcast,9,9,866,614,945,710,79,96,905.5,662.0,0.9327740669250488
21,broadcast,2,2,1543,705,1640,827,97,122,1591.5,766.0,0.9259961247444153
21,broadcast,3,3,653,721,721,844,68,123,687.0,782.5,0.9184802770614624
21,broadcast,8,8,1533,441,1576,524,43,83,1554.5,482.5,0.9072553515434265
21,broadcast,14,14,857,559,917,653,60,94,887.0,606.0,0.8938130736351013
21,broadcast,11,11,1549,490,1617,581,68,91,1583.0,535.5,0.8930174708366394
21,broadcast,12,12,1618,559,1671,670,53,111,1644.5,614.5,0.8904111385345459
21,broadcast,5,5,986,556,1038,650,52,94,1012.0,603.0,0.8862653374671936
21,broadcast,7,7,1662,453,1695,534,33,81,1678.5,493.5,0.8720632195472717
21,broadcast,10,10,1857,592,1899,700,42,108,1878.0,646.0,0.8577525615692139
21,tacticam,11,14,307,411,346,467,39,56,326.5,439.0,0.936214029788971
21,tacticam,17,31,422,199,460,257,38,58,441.0,228.0,0.9238219261169434
21,tacticam,2,15,1701,328,1745,391,44,63,1723.0,359.5,0.9191127419471741
21,tacticam,10,3,268,757,308,830,40,73,288.0,793.5,0.918432891368866
21,tacticam,8,8,1323,808,1368,883,45,75,1345.5,845.5,0.9123650193214417
21,tacticam,1,9,293,496,334,564,41,68,313.5,530.0,0.911267101764679
21,tacticam,19,27,571,105,600,152,29,47,585.5,128.5,0.9091149568557739
21,tacticam,21,16,889,157,923,205,34,48,906.0,181.0,0.9089930653572083
21,tacticam,16,4,784,249,816,301,32,52,800.0,275.0,0.9075246453285217
21,tacticam,12,19,708,345,742,398,34,53,725.0,371.5,0.9056395888328552
21,tacticam,3,12,1108,482,1135,544,27,62,1121.5,513.0,0.9048754572868347
21,tacticam,7,29,1674,466,1709,528,35,62,1691.5,497.0,0.9045847654342651
21,tacticam,13,10,748,392,777,447,29,55,762.5,419.5,0.8992136716842651
21,tacticam,20,17,824,151,855,193,31,42,839.5,172.0,0.897386372089386
21,tacticam,15,11,984,152,1011,198,27,46,997.5,175.0,0.8963620662689209
21,tacticam,6,22,1138,356,1167,413,29,57,1152.5,384.5,0.8878124952316284
21,tacticam,18,7,1493,234,1518,283,25,49,1505.5,258.5,0.8875881433486938
21,tacticam,4,20,919,204,947,250,28,46,933.0,227.0,0.8837997317314148
22,broadcast,3,3,653,719,717,845,64,126,685.0,782.0,0.9230061173439026
22,broadcast,9,9,871,611,943,712,72,101,907.0,661.5,0.92194664478302
22,broadcast,16,16,1309,475,1378,564,69,89,1343.5,519.5,0.9139063954353333
22,broadcast,2,2,1536,705,1605,822,69,117,1570.5,763.5,0.9134409427642822
22,broadcast,7,7,1653,451,1707,536,54,85,1680.0,493.5,0.9108695983886719
22,broadcast,5,5,985,554,1050,648,65,94,1017.5,601.0,0.9101646542549133
22,broadcast,12,12,1617,559,1682,670,65,111,1649.5,614.5,0.9043208956718445
22,broadcast,11,11,1545,493,1616,584,71,91,1580.5,538.5,0.8896270990371704
22,broadcast,8,8,1545,444,1578,525,33,81,1561.5,484.5,0.875750720500946
22,broadcast,14,14,865,558,922,656,57,98,893.5,607.0,0.8618673086166382
22,broadcast,10,10,1860,590,1907,698,47,108,1883.5,644.0,0.834449827671051
22,tacticam,11,14,310,413,347,466,37,53,328.5,439.5,0.9359714984893799
22,tacticam,16,4,782,249,816,301,34,52,799.0,275.0,0.9221727252006531
22,tacticam,10,3,269,753,311,829,42,76,290.0,791.0,0.9221572279930115
22,tacticam,17,31,424,200,465,255,41,55,444.5,227.5,0.9201188087463379
22,tacticam,3,12,1107,480,1138,542,31,62,1122.5,511.0,0.9188385009765625
22,tacticam,5,2,823,569,875,632,52,63,849.0,600.5,0.918772280216217
22,tacticam,1,9,295,493,340,563,45,70,317.5,528.0,0.915920078754425
22,tacticam,12,19,710,344,742,399,32,55,726.0,371.5,0.9138244986534119
22,tacticam,8,8,1324,807,1369,881,45,74,1346.5,844.0,0.9119884371757507
22,tacticam,19,27,575,106,604,153,29,47,589.5,129.5,0.9106560349464417
22,tacticam,21,16,889,159,926,208,37,49,907.5,183.5,0.9106488823890686
22,tacticam,2,15,1706,331,1742,392,36,61,1724.0,361.5,0.9061212539672852
22,tacticam,7,29,1675,468,1704,529,29,61,1689.5,498.5,0.9017828702926636
22,tacticam,6,22,1139,358,1167,414,28,56,1153.0,386.0,0.8917512893676758
22,tacticam,15,11,981,153,1009,199,28,46,995.0,176.0,0.8914320468902588
22,tacticam,13,10,746,391,770,447,24,56,758.0,419.0,0.885930061340332
22,tacticam,18,7,1493,234,1519,284,26,50,1506.0,259.0,0.8803627490997314
22,tacticam,14,5,976,271,996,330,20,59,986.0,300.5,0.8748065829277039
22,tacticam,4,20,920,206,951,251,31,45,935.5,228.5,0.8660305142402649
23,broadcast,3,3,657,717,717,842,60,125,687.0,779.5,0.9266897439956665
23,broadcast,12,12,1615,558,1691,664,76,106,1653.0,611.0,0.922166645526886
23,broadcast,2,2,1534,705,1627,824,93,119,1580.5,764.5,0.9215896725654602
23,broadcast,5,5,983,552,1058,647,75,95,1020.5,599.5,0.9165772199630737
23,broadcast,16,16,1313,476,1378,564,65,88,1345.5,520.0,0.9095996618270874
23,broadcast,8,8,1546,445,1582,518,36,73,1564.0,481.5,0.8965105414390564
23,broadcast,14,14,879,557,927,643,48,86,903.0,600.0,0.8944254517555237
23,broadcast,11,11,1548,494,1621,587,73,93,1584.5,540.5,0.884685754776001
23,broadcast,9,9,875,612,935,712,60,100,905.0,662.0,0.8771427273750305
23,broadcast,10,10,1863,588,1918,692,55,104,1890.5,640.0,0.8448037505149841
23,tacticam,10,3,268,747,317,824,49,77,292.5,785.5,0.9307436347007751
23,tacticam,11,14,311,412,347,466,36,54,329.0,439.0,0.9256541132926941
23,tacticam,19,27,575,107,610,154,35,47,592.5,130.5,0.9233331084251404
23,tacticam,16,4,781,249,819,301,38,52,800.0,275.0,0.9204833507537842
23,tacticam,3,12,1107,479,1140,541,33,62,1123.5,510.0,0.9198172092437744
23,tacticam,17,31,427,200,468,256,41,56,447.5,228.0,0.9195422530174255
23,tacticam,1,9,297,492,345,554,48,62,321.0,523.0,0.9194809794425964
23,tacticam,8,8,1321,808,1369,878,48,70,1345.0,843.0,0.9163015484809875
23,tacticam,12,19,710,344,745,399,35,55,727.5,371.5,0.9118594527244568
23,tacticam,14,5,974,271,1003,331,29,60,988.5,301.0,0.9090471267700195
23,tacticam,9,21,334,366,373,420,39,54,353.5,393.0,0.9063421487808228
23,tacticam,21,16,889,161,926,209,37,48,907.5,185.0,0.9032783508300781
23,tacticam,7,29,1674,468,1701,529,27,61,1687.5,498.5,0.9019591808319092
23,tacticam,2,15,1710,332,1738,393,28,61,1724.0,362.5,0.8978325724601746
23,tacticam,18,7,1493,234,1520,284,27,50,1506.5,259.0,0.8969864845275879
23,tacticam,15,11,979,153,1012,200,33,47,995.5,176.5,0.8931882381439209
23,tacticam,5,2,824,568,867,632,43,64,845.5,600.0,0.8929212689399719
23,tacticam,4,20,918,206,955,252,37,46,936.5,229.0,0.8886637091636658
23,tacticam,13,10,748,390,771,447,23,57,759.5,418.5,0.8648314476013184
24,broadcast,2,2,1533,707,1623,830,90,123,1578.0,768.5,0.9187658429145813
24,broadcast,3,3,664,712,719,839,55,127,691.5,775.5,0.9101915955543518
24,broadcast,11,11,1556,495,1613,588,57,93,1584.5,541.5,0.8928056359291077
24,broadcast,8,8,1545,444,1587,526,42,82,1566.0,485.0,0.878819465637207
24,broadcast,14,14,886,555,931,641,45,86,908.5,598.0,0.8787726163864136
24,broadcast,10,10,1866,587,1920,691,54,104,1893.0,639.0,0.8702943325042725
24,broadcast,16,16,1318,475,1361,560,43,85,1339.5,517.5,0.8544983863830566
24,broadcast,9,9,882,613,921,711,39,98,901.5,662.0,0.8180073499679565
24,broadcast,15,15,227,509,266,613,39,104,246.5,561.0,0.6870911121368408
24,tacticam,1,9,300,491,347,552,47,61,323.5,521.5,0.932361364364624
24,tacticam,10,3,268,743,319,817,51,74,293.5,780.0,0.9310377240180969
24,tacticam,3,12,1103,480,1141,542,38,62,1122.0,511.0,0.9214850068092346
24,tacticam,19,27,577,109,613,153,36,44,595.0,131.0,0.9199752807617188
24,tacticam,13,10,748,388,776,447,28,59,762.0,417.5,0.9190008044242859
24,tacticam,20,17,815,155,849,201,34,46,832.0,178.0,0.9167873859405518
24,tacticam,8,8,1320,807,1366,876,46,69,1343.0,841.5,0.9167147278785706
24,tacticam,12,19,710,342,747,396,37,54,728.5,369.0,0.9151360392570496
24,tacticam,11,14,314,412,352,466,38,54,333.0,439.0,0.9149484634399414
24,tacticam,17,31,428,202,470,257,42,55,449.0,229.5,0.9138028621673584
24,tacticam,18,7,1494,234,1522,284,28,50,1508.0,259.0,0.9136765599250793
24,tacticam,14,5,975,272,1007,332,32,60,991.0,302.0,0.9118362665176392
24,tacticam,15,11,980,154,1015,199,35,45,997.5,176.5,0.909280002117157
24,tacticam,5,2,818,568,859,632,41,64,838.5,600.0,0.9077017903327942
24,tacticam,7,29,1673,468,1700,529,27,61,1686.5,498.5,0.903192400932312
24,tacticam,9,21,333,365,369,421,36,56,351.0,393.0,0.9029349684715271
24,tacticam,21,16,890,163,924,210,34,47,907.0,186.5,0.9020829200744629
24,tacticam,2,15,1710,334,1733,393,23,59,1721.5,363.5,0.8861327767372131
24,tacticam,4,20,917,206,954,253,37,47,935.5,229.5,0.8801881074905396
25,broadcast,3,3,672,710,726,836,54,126,699.0,773.0,0.9167843461036682
25,broadcast,12,12,1608,558,1689,659,81,101,1648.5,608.5,0.909886360168457
25,broadcast,2,2,1527,706,1590,829,63,123,1558.5,767.5,0.8989793062210083
25,broadcast,8,8,1544,443,1588,527,44,84,1566.0,485.0,0.8872048854827881
25,broadcast,9,9,881,604,923,710,42,106,902.0,657.0,0.8865845203399658
25,broadcast,7,7,1640,451,1699,532,59,81,1669.5,491.5,0.8849913477897644
25,broadcast,16,16,1320,476,1370,564,50,88,1345.0,520.0,0.8752899169921875
25,broadcast,14,14,893,552,938,641,45,89,915.5,596.5,0.8533145189285278
25,broadcast,11,11,1561,529,1588,588,27,59,1574.5,558.5,0.8354488015174866
25,broadcast,15,15,238,509,277,612,39,103,257.5,560.5,0.8256287574768066
25,broadcast,10,10,1873,588,1920,694,47,106,1896.5,641.0,0.8158553242683411
25,broadcast,17,17,1564,493,1597,565,33,72,1580.5,529.0,0.6336483359336853
25,tacticam,10,3,267,740,322,809,55,69,294.5,774.5,0.9263045787811279
25,tacticam,1,9,303,490,345,551,42,61,324.0,520.5,0.9240567088127136
25,tacticam,13,10,748,384,780,446,32,62,764.0,415.0,0.9227935075759888
25,tacticam,3,12,1104,480,1137,541,33,61,1120.5,510.5,0.9224056601524353
25,tacticam,17,31,430,205,470,261,40,56,450.0,233.0,0.9202781915664673
25,tacticam,11,14,314,409,359,467,45,58,336.5,438.0,0.9186116456985474
25,tacticam,18,7,1491,234,1524,285,33,51,1507.5,259.5,0.9184773564338684
25,tacticam,6,22,1142,361,1168,415,26,54,1155.0,388.0,0.9156489372253418
25,tacticam,5,2,818,566,851,632,33,66,834.5,599.0,0.9149967432022095
25,tacticam,8,8,1319,805,1364,877,45,72,1341.5,841.0,0.9124302268028259
25,tacticam,7,29,1672,468,1703,529,31,61,1687.5,498.5,0.9119913578033447
25,tacticam,19,27,579,110,616,155,37,45,597.5,132.5,0.9113149046897888
25,tacticam,12,19,709,342,749,397,40,55,729.0,369.5,0.9095491170883179
25,tacticam,20,17,816,158,841,202,25,44,828.5,180.0,0.9082633852958679
25,tacticam,14,5,978,274,1013,332,35,58,995.5,303.0,0.9064123630523682
25,tacticam,2,15,1709,334,1730,395,21,61,1719.5,364.5,0.8965617418289185
25,tacticam,9,21,335,365,374,421,39,56,354.5,393.0,0.8874677419662476
25,tacticam,4,20,921,209,952,255,31,46,936.5,232.0,0.8857293725013733
25,tacticam,21,16,890,165,919,213,29,48,904.5,189.0,0.8555517792701721
26,broadcast,2,2,1526,705,1599,829,73,124,1562.5,767.0,0.9225966930389404
26,broadcast,3,3,676,706,732,825,56,119,704.0,765.5,0.9092008471488953
26,broadcast,16,16,1325,475,1380,565,55,90,1352.5,520.0,0.9059475660324097
26,broadcast,5,5,990,547,1053,639,63,92,1021.5,593.0,0.9040970802307129
26,broadcast,12,12,1612,559,1686,663,74,104,1649.0,611.0,0.8972635865211487
26,broadcast,9,9,882,594,929,708,47,114,905.5,651.0,0.8954522013664246
26,broadcast,8,8,1539,444,1587,521,48,77,1563.0,482.5,0.8949218392372131
26,broadcast,7,7,1646,451,1685,534,39,83,1665.5,492.5,0.8866864442825317
26,broadcast,17,17,1556,492,1597,588,41,96,1576.5,540.0,0.8844982385635376
26,broadcast,14,14,900,549,945,633,45,84,922.5,591.0,0.8801069259643555
26,broadcast,10,10,1882,589,1920,694,38,105,1901.0,641.5,0.8147615194320679
26,broadcast,15,15,248,510,288,613,40,103,268.0,561.5,0.698391854763031
26,tacticam,14,5,983,275,1018,333,35,58,1000.5,304.0,0.930042564868927
26,tacticam,7,29,1671,468,1704,530,33,62,1687.5,499.0,0.920011043548584
26,tacticam,18,7,1490,237,1524,286,34,49,1507.0,261.5,0.9167410731315613
26,tacticam,13,10,746,385,784,445,38,60,765.0,415.0,0.9166660308837891
26,tacticam,10,3,270,737,317,806,47,69,293.5,771.5,0.9162200093269348
26,tacticam,12,19,708,342,746,397,38,55,727.0,369.5,0.9154179096221924
26,tacticam,5,2,816,565,855,631,39,66,835.5,598.0,0.9126061201095581
26,tacticam,6,22,1144,361,1170,414,26,53,1157.0,387.5,0.9105634093284607
26,tacticam,11,14,319,409,363,462,44,53,341.0,435.5,0.9089632034301758
26,tacticam,3,12,1107,481,1137,541,30,60,1122.0,511.0,0.9084252715110779
26,tacticam,8,8,1320,802,1362,876,42,74,1341.0,839.0,0.9080637097358704
26,tacticam,20,17,814,157,839,202,25,45,826.5,179.5,0.9080585837364197
26,tacticam,1,9,307,489,337,551,30,62,322.0,520.0,0.9035512804985046
26,tacticam,2,15,1707,334,1733,396,26,62,1720.0,365.0,0.9033586382865906
26,tacticam,19,27,580,112,615,156,35,44,597.5,134.0,0.9033475518226624
26,tacticam,16,4,775,253,811,303,36,50,793.0,278.0,0.8956567049026489
26,tacticam,17,31,434,205,460,260,26,55,447.0,232.5,0.8948375582695007
26,tacticam,15,11,978,157,1013,201,35,44,995.5,179.0,0.8922048211097717
26,tacticam,9,21,335,364,382,421,47,57,358.5,392.5,0.8820855617523193
26,tacticam,21,16,890,166,917,213,27,47,903.5,189.5,0.8758469223976135
26,tacticam,4,20,924,212,950,258,26,46,937.0,235.0,0.860378623008728
26,tacticam,23,33,499,80,526,126,27,46,512.5,103.0,0.737759530544281
27,broadcast,2,2,1524,702,1592,829,68,127,1558.0,765.5,0.9298980236053467
27,broadcast,9,9,881,595,935,705,54,110,908.0,650.0,0.9223939180374146
27,broadcast,3,3,675,705,731,823,56,118,703.0,764.0,0.9132471680641174
27,broadcast,7,7,1640,452,1678,534,38,82,1659.0,493.0,0.9075579643249512
27,broadcast,16,16,1326,473,1387,564,61,91,1356.5,518.5,0.9064950346946716
27,broadcast,5,5,993,546,1057,639,64,93,1025.0,592.5,0.8948850631713867
27,broadcast,8,8,1541,445,1584,518,43,73,1562.5,481.5,0.8855015635490417
27,broadcast,12,12,1611,560,1676,663,65,103,1643.5,611.5,0.8852301239967346
27,broadcast,14,14,905,546,951,635,46,89,928.0,590.5,0.8805942535400391
27,broadcast,17,17,1548,492,1601,586,53,94,1574.5,539.0,0.8798733949661255
27,broadcast,15,15,259,510,299,613,40,103,279.0,561.5,0.771168053150177
27,broadcast,10,10,1885,588,1920,693,35,105,1902.5,640.5,0.7413669228553772
27,tacticam,5,2,814,563,859,630,45,67,836.5,596.5,0.9267473816871643
27,tacticam,7,29,1666,468,1705,530,39,62,1685.5,499.0,0.9230415225028992
27,tacticam,6,22,1143,359,1174,415,31,56,1158.5,387.0,0.9227628111839294
27,tacticam,2,15,1699,335,1734,397,35,62,1716.5,366.0,0.9175975322723389
27,tacticam,8,8,1322,799,1363,873,41,74,1342.5,836.0,0.916597843170166
27,tacticam,10,3,273,733,312,804,39,71,292.5,768.5,0.916251003742218
27,tacticam,18,7,1489,239,1523,289,34,50,1506.0,264.0,0.9160339832305908
27,tacticam,11,14,324,400,368,461,44,61,346.0,430.5,0.9157721996307373
27,tacticam,20,17,811,158,844,204,33,46,827.5,181.0,0.9135531783103943
27,tacticam,13,10,747,387,787,444,40,57,767.0,415.5,0.9126480221748352
27,tacticam,14,5,988,276,1023,335,35,59,1005.5,305.5,0.9104692935943604
27,tacticam,16,4,774,253,804,303,30,50,789.0,278.0,0.9078930616378784
27,tacticam,1,9,312,489,340,549,28,60,326.0,519.0,0.9061411619186401
27,tacticam,21,16,891,169,922,214,31,45,906.5,191.5,0.9005191922187805
27,tacticam,17,31,438,207,466,261,28,54,452.0,234.0,0.9004371166229248
27,tacticam,12,19,712,344,751,399,39,55,731.5,371.5,0.8997084498405457
27,tacticam,15,11,977,158,1009,203,32,45,993.0,180.5,0.8957417607307434
27,tacticam,3,12,1109,481,1133,541,24,60,1121.0,511.0,0.8918376564979553
27,tacticam,19,27,584,115,617,158,33,43,600.5,136.5,0.8812791705131531
27,tacticam,4,20,924,213,947,259,23,46,935.5,236.0,0.8127063512802124
28,broadcast,2,2,1521,700,1596,828,75,128,1558.5,764.0,0.9432372450828552
28,broadcast,16,16,1323,473,1393,559,70,86,1358.0,516.0,0.9105852246284485
28,broadcast,7,7,1630,451,1684,534,54,83,1657.0,492.5,0.9091917872428894
28,broadcast,3,3,677,704,727,825,50,121,702.0,764.5,0.9070161581039429
28,broadcast,9,9,879,591,939,700,60,109,909.0,645.5,0.9051694273948669
28,broadcast,5,5,997,542,1057,637,60,95,1027.0,589.5,0.8990307450294495
28,broadcast,14,14,909,544,959,636,50,92,934.0,590.0,0.8932995200157166
28,broadcast,17,17,1536,492,1604,581,68,89,1570.0,536.5,0.8889726996421814
28,broadcast,12,12,1605,560,1659,664,54,104,1632.0,612.0,0.8872278332710266
28,broadcast,8,8,1546,447,1583,509,37,62,1564.5,478.0,0.8822726607322693
28,broadcast,10,10,1891,587,1920,693,29,106,1905.5,640.0,0.8116369247436523
28,tacticam,2,15,1693,335,1734,398,41,63,1713.5,366.5,0.9311068654060364
28,tacticam,6,22,1139,361,1177,416,38,55,1158.0,388.5,0.9297001361846924
28,tacticam,5,2,811,562,859,624,48,62,835.0,593.0,0.9284726977348328
28,tacticam,7,29,1661,469,1705,529,44,60,1683.0,499.0,0.9210233688354492
28,tacticam,10,3,274,731,306,801,32,70,290.0,766.0,0.9206843376159668
28,tacticam,8,8,1322,797,1364,871,42,74,1343.0,834.0,0.9197516441345215
28,tacticam,11,14,329,401,368,456,39,55,348.5,428.5,0.9156111478805542
28,tacticam,21,16,888,170,925,215,37,45,906.5,192.5,0.91554194688797
28,tacticam,1,9,318,487,345,549,27,62,331.5,518.0,0.9100601673126221
28,tacticam,14,5,993,277,1026,335,33,58,1009.5,306.0,0.9086615443229675
28,tacticam,16,4,772,255,801,303,29,48,786.5,279.0,0.9054468274116516
28,tacticam,12,19,716,345,750,399,34,54,733.0,372.0,0.9003161191940308
28,tacticam,3,12,1106,482,1128,541,22,59,1117.0,511.5,0.8974825739860535
28,tacticam,18,7,1492,242,1519,291,27,49,1505.5,266.5,0.893702507019043
28,tacticam,17,31,442,207,468,260,26,53,455.0,233.5,0.8881388306617737
28,tacticam,15,11,978,160,1002,207,24,47,990.0,183.5,0.886827826499939
28,tacticam,13,10,751,388,787,446,36,58,769.0,417.0,0.8571822047233582
28,tacticam,4,20,923,214,949,260,26,46,936.0,237.0,0.8520017266273499
28,tacticam,19,27,585,118,619,160,34,42,602.0,139.0,0.8495269417762756
29,broadcast,2,2,1522,698,1597,819,75,121,1559.5,758.5,0.9404717087745667
29,broadcast,5,5,998,539,1063,634,65,95,1030.5,586.5,0.9166932106018066
29,broadcast,12,12,1608,558,1658,664,50,106,1633.0,611.0,0.9128003716468811
29,broadcast,3,3,678,701,725,824,47,123,701.5,762.5,0.9072496294975281
29,broadcast,9,9,868,592,940,699,72,107,904.0,645.5,0.9050391912460327
29,broadcast,7,7,1620,450,1684,527,64,77,1652.0,488.5,0.9044912457466125
29,broadcast,14,14,911,543,966,633,55,90,938.5,588.0,0.9019431471824646
29,broadcast,17,17,1535,492,1605,581,70,89,1570.0,536.5,0.8783466815948486
29,broadcast,8,8,1541,447,1581,512,40,65,1561.0,479.5,0.8732368350028992
29,broadcast,10,10,1895,585,1920,686,25,101,1907.5,635.5,0.7898128628730774
29,broadcast,15,15,281,509,321,613,40,104,301.0,561.0,0.7641273140907288
29,tacticam,2,15,1691,337,1733,398,42,61,1712.0,367.5,0.9311147928237915
29,tacticam,10,3,276,726,310,799,34,73,293.0,762.5,0.9270861148834229
29,tacticam,5,2,811,562,856,622,45,60,833.5,592.0,0.9248757362365723
29,tacticam,6,22,1142,361,1179,417,37,56,1160.5,389.0,0.9227453470230103
29,tacticam,8,8,1325,794,1366,870,41,76,1345.5,832.0,0.9209410548210144
29,tacticam,11,14,332,402,367,456,35,54,349.5,429.0,0.9164624214172363
29,tacticam,16,4,769,255,804,305,35,50,786.5,280.0,0.9158304929733276
29,tacticam,4,20,923,216,954,261,31,45,938.5,238.5,0.9153525829315186
29,tacticam,7,29,1662,470,1704,531,42,61,1683.0,500.5,0.9128797650337219
29,tacticam,17,31,446,207,474,263,28,56,460.0,235.0,0.9119769334793091
29,tacticam,3,12,1105,481,1131,541,26,60,1118.0,511.0,0.908697247505188
29,tacticam,14,5,999,279,1028,335,29,56,1013.5,307.0,0.908118724822998
29,tacticam,1,9,319,484,352,547,33,63,335.5,515.5,0.9072561860084534
29,tacticam,12,19,718,346,745,400,27,54,731.5,373.0,0.8929439187049866
29,tacticam,15,11,976,162,999,207,23,45,987.5,184.5,0.8895299434661865
29,tacticam,19,27,587,120,617,161,30,41,602.0,140.5,0.8782957792282104
29,tacticam,18,7,1493,245,1516,294,23,49,1504.5,269.5,0.8781508207321167
30,broadcast,2,2,1509,699,1594,819,85,120,1551.5,759.0,0.9280440807342529
30,broadcast,12,12,1605,556,1664,666,59,110,1634.5,611.0,0.916966438293457
30,broadcast,3,3,679,697,726,823,47,126,702.5,760.0,0.9134572744369507
30,broadcast,5,5,999,538,1063,628,64,90,1031.0,583.0,0.9093360900878906
30,broadcast,14,14,913,543,970,631,57,88,941.5,587.0,0.9019819498062134
30,broadcast,9,9,875,592,940,701,65,109,907.5,646.5,0.9008891582489014
30,broadcast,17,17,1533,490,1598,583,65,93,1565.5,536.5,0.8842612504959106
30,broadcast,8,8,1538,447,1581,513,43,66,1559.5,480.0,0.8831551671028137
30,tacticam,10,3,276,721,316,795,40,74,296.0,758.0,0.9319370985031128
30,tacticam,8,8,1327,793,1368,867,41,74,1347.5,830.0,0.92558354139328
30,tacticam,2,15,1692,339,1732,399,40,60,1712.0,369.0,0.9223543405532837
30,tacticam,5,2,812,561,847,623,35,62,829.5,592.0,0.9173325300216675
30,tacticam,1,9,320,482,359,546,39,64,339.5,514.0,0.9157166481018066
30,tacticam,17,31,449,207,481,264,32,57,465.0,235.5,0.9156147837638855
30,tacticam,4,20,922,217,957,260,35,43,939.5,238.5,0.9153519868850708
30,tacticam,6,22,1147,364,1179,418,32,54,1163.0,391.0,0.91370689868927
30,tacticam,3,12,1103,480,1134,540,31,60,1118.5,510.0,0.9128735065460205
30,tacticam,14,5,1004,279,1029,336,25,57,1016.5,307.5,0.9022510647773743
30,tacticam,7,29,1664,472,1700,531,36,59,1682.0,501.5,0.9020258784294128
30,tacticam,20,17,805,163,835,207,30,44,820.0,185.0,0.9000275731086731
30,tacticam,11,14,336,405,368,455,32,50,352.0,430.0,0.8982282876968384
30,tacticam,12,19,718,345,743,399,25,54,730.5,372.0,0.8965936303138733
30,tacticam,15,11,973,163,1005,208,32,45,989.0,185.5,0.8938798904418945
30,tacticam,18,7,1492,247,1514,295,22,48,1503.0,271.0,0.8893383145332336
30,tacticam,19,27,590,123,623,163,33,40,606.5,143.0,0.8888915181159973
30,tacticam,9,21,340,366,377,413,37,47,358.5,389.5,0.8843921422958374
31,broadcast,2,2,1501,698,1586,819,85,121,1543.5,758.5,0.9262077212333679
31,broadcast,5,5,999,535,1064,630,65,95,1031.5,582.5,0.9154913425445557
31,broadcast,12,12,1601,555,1669,662,68,107,1635.0,608.5,0.9149911999702454
31,broadcast,3,3,679,692,729,816,50,124,704.0,754.0,0.9125995635986328
31,broadcast,14,14,913,542,974,636,61,94,943.5,589.0,0.906439483165741
31,broadcast,17,17,1533,492,1590,586,57,94,1561.5,539.0,0.8962316513061523
31,broadcast,7,7,1611,451,1663,531,52,80,1637.0,491.0,0.8936666250228882
31,broadcast,9,9,876,596,934,702,58,106,905.0,649.0,0.8919506669044495
31,broadcast,8,8,1542,446,1579,511,37,65,1560.5,478.5,0.8483160734176636
31,tacticam,10,3,275,717,321,786,46,69,298.0,751.5,0.9378598928451538
31,tacticam,8,8,1329,793,1369,865,40,72,1349.0,829.0,0.9327980279922485
31,tacticam,1,9,321,480,364,541,43,61,342.5,510.5,0.9291415810585022
31,tacticam,3,12,1102,480,1135,538,33,58,1118.5,509.0,0.9235181212425232
31,tacticam,17,31,450,207,487,263,37,56,468.5,235.0,0.9209528565406799
31,tacticam,15,11,973,165,1006,208,33,43,989.5,186.5,0.9156141877174377
31,tacticam,5,2,811,561,841,622,30,61,826.0,591.5,0.9148814082145691
31,tacticam,2,15,1696,341,1728,400,32,59,1712.0,370.5,0.9092053771018982
31,tacticam,6,22,1150,367,1171,419,21,52,1160.5,393.0,0.9070228338241577
31,tacticam,11,14,337,405,375,455,38,50,356.0,430.0,0.9049767851829529
31,tacticam,12,19,718,345,747,398,29,53,732.5,371.5,0.9039356708526611
31,tacticam,21,16,890,175,925,220,35,45,907.5,197.5,0.9008374214172363
31,tacticam,18,7,1491,247,1514,295,23,48,1502.5,271.0,0.8925821781158447
31,tacticam,7,29,1665,473,1694,532,29,59,1679.5,502.5,0.8827252984046936
31,tacticam,9,21,340,366,375,415,35,49,357.5,390.5,0.8691036701202393
31,tacticam,13,10,755,388,780,445,25,57,767.5,416.5,0.7164133191108704
32,broadcast,2,2,1506,699,1573,819,67,120,1539.5,759.0,0.9223018288612366
32,broadcast,12,12,1596,555,1672,657,76,102,1634.0,606.0,0.9220975041389465
32,broadcast,3,3,680,689,733,807,53,118,706.5,748.0,0.9204139113426208
32,broadcast,5,5,998,534,1061,631,63,97,1029.5,582.5,0.914625346660614
32,broadcast,14,14,916,540,977,635,61,95,946.5,587.5,0.9002996683120728
32,broadcast,9,9,880,597,927,700,47,103,903.5,648.5,0.8882297873497009
32,broadcast,7,7,1616,451,1647,531,31,80,1631.5,491.0,0.8754080533981323
32,broadcast,17,17,1537,490,1580,585,43,95,1558.5,537.5,0.8635550141334534
32,broadcast,8,8,1533,447,1577,530,44,83,1555.0,488.5,0.8087413311004639
32,tacticam,8,8,1332,792,1369,863,37,71,1350.5,827.5,0.9344860911369324
32,tacticam,3,12,1099,480,1138,539,39,59,1118.5,509.5,0.9328071475028992
32,tacticam,10,3,274,714,322,779,48,65,298.0,746.5,0.9263541102409363
32,tacticam,1,9,322,480,366,537,44,57,344.0,508.5,0.9254724383354187
32,tacticam,17,31,450,209,491,262,41,53,470.5,235.5,0.9234959483146667
32,tacticam,5,2,809,560,838,622,29,62,823.5,591.0,0.916169285774231
32,tacticam,16,4,761,257,801,307,40,50,781.0,282.0,0.9125490188598633
32,tacticam,6,22,1150,367,1174,421,24,54,1162.0,394.0,0.9077144861221313
32,tacticam,4,20,922,220,957,265,35,45,939.5,242.5,0.9035977721214294
32,tacticam,12,19,718,345,752,398,34,53,735.0,371.5,0.9029637575149536
32,tacticam,18,7,1492,248,1518,296,26,48,1505.0,272.0,0.8989700675010681
32,tacticam,13,10,757,387,784,443,27,56,770.5,415.0,0.8975011706352234
32,tacticam,2,15,1699,343,1725,402,26,59,1712.0,372.5,0.895999014377594
32,tacticam,7,29,1665,473,1691,533,26,60,1678.0,503.0,0.8947755694389343
32,tacticam,21,16,890,177,923,222,33,45,906.5,199.5,0.8898067474365234
32,tacticam,9,21,341,367,377,414,36,47,359.0,390.5,0.8594427108764648
32,tacticam,20,17,803,166,829,212,26,46,816.0,189.0,0.6866791248321533
33,broadcast,3,3,682,687,738,801,56,114,710.0,744.0,0.9212999939918518
33,broadcast,2,2,1498,699,1557,821,59,122,1527.5,760.0,0.9197583198547363
33,broadcast,12,12,1589,554,1666,657,77,103,1627.5,605.5,0.9194293022155762
33,broadcast,16,16,1318,479,1388,564,70,85,1353.0,521.5,0.9111145734786987
33,broadcast,7,7,1610,452,1644,531,34,79,1627.0,491.5,0.9071567058563232
33,broadcast,5,5,999,532,1057,633,58,101,1028.0,582.5,0.9070144891738892
33,broadcast,14,14,920,539,975,636,55,97,947.5,587.5,0.9059245586395264
33,broadcast,9,9,879,595,923,701,44,106,901.0,648.0,0.8888893723487854
33,broadcast,17,17,1535,489,1576,583,41,94,1555.5,536.0,0.8156150579452515
33,broadcast,8,8,1540,447,1575,514,35,67,1557.5,480.5,0.7801113128662109
33,tacticam,8,8,1333,792,1366,862,33,70,1349.5,827.0,0.9320167899131775
33,tacticam,5,2,807,558,844,621,37,63,825.5,589.5,0.9243689775466919
33,tacticam,1,9,326,479,367,536,41,57,346.5,507.5,0.9242215156555176
33,tacticam,3,12,1101,480,1135,538,34,58,1118.0,509.0,0.9228120446205139
33,tacticam,12,19,717,345,755,399,38,54,736.0,372.0,0.9197944402694702
33,tacticam,20,17,800,169,832,213,32,44,816.0,191.0,0.9197561144828796
33,tacticam,10,3,278,710,318,776,40,66,298.0,743.0,0.9154456853866577
33,tacticam,17,31,453,211,494,264,41,53,473.5,237.5,0.9132925868034363
33,tacticam,18,7,1491,248,1518,298,27,50,1504.5,273.0,0.9093934297561646
33,tacticam,16,4,760,260,793,309,33,49,776.5,284.5,0.9060412049293518
33,tacticam,13,10,756,386,790,443,34,57,773.0,414.5,0.9030308723449707
33,tacticam,6,22,1151,367,1173,421,22,54,1162.0,394.0,0.8978392481803894
33,tacticam,21,16,890,179,919,222,29,43,904.5,200.5,0.8922569155693054
33,tacticam,7,29,1663,473,1689,533,26,60,1676.0,503.0,0.8899774551391602
33,tacticam,4,20,925,222,955,268,30,46,940.0,245.0,0.8844719529151917
33,tacticam,2,15,1698,343,1718,403,20,60,1708.0,373.0,0.873816728591919
33,tacticam,19,27,602,129,631,173,29,44,616.5,151.0,0.8691740036010742
33,tacticam,11,14,340,398,383,452,43,54,361.5,425.0,0.845762312412262
34,broadcast,14,14,924,538,977,633,53,95,950.5,585.5,0.9241963028907776
34,broadcast,2,2,1497,696,1549,821,52,125,1523.0,758.5,0.9234828352928162
34,broadcast,3,3,683,686,734,803,51,117,708.5,744.5,0.9085879325866699
34,broadcast,7,7,1601,453,1648,532,47,79,1624.5,492.5,0.9009524583816528
34,broadcast,5,5,997,530,1054,632,57,102,1025.5,581.0,0.8995237946510315
34,broadcast,12,12,1592,558,1645,661,53,103,1618.5,609.5,0.8868088722229004
34,broadcast,9,9,880,592,924,700,44,108,902.0,646.0,0.8845261335372925
34,broadcast,16,16,1315,479,1380,563,65,84,1347.5,521.0,0.8732045292854309
34,broadcast,17,17,1544,450,1573,524,29,74,1558.5,487.0,0.7156217694282532
34,broadcast,8,8,1518,395,1555,463,37,68,1536.5,429.0,0.6268123984336853
34,broadcast,18,18,1531,502,1573,586,42,84,1552.0,544.0,0.8182940483093262
34,tacticam,5,2,804,557,847,617,43,60,825.5,587.0,0.9335445165634155
34,tacticam,10,3,278,706,314,774,36,68,296.0,740.0,0.9200460314750671
34,tacticam,13,10,755,386,796,442,41,56,775.5,414.0,0.918134331703186
34,tacticam,8,8,1334,790,1363,858,29,68,1348.5,824.0,0.9153167605400085
34,tacticam,18,7,1488,250,1520,300,32,50,1504.0,275.0,0.9135298132896423
34,tacticam,1,9,329,480,367,536,38,56,348.0,508.0,0.9113976359367371
34,tacticam,12,19,715,345,757,399,42,54,736.0,372.0,0.9102858304977417
34,tacticam,6,22,1151,367,1177,420,26,53,1164.0,393.5,0.9096631407737732
34,tacticam,3,12,1105,480,1132,538,27,58,1118.5,509.0,0.9065434336662292
34,tacticam,16,4,761,260,787,309,26,49,774.0,284.5,0.9053031802177429
34,tacticam,7,29,1661,473,1689,534,28,61,1675.0,503.5,0.9027647376060486
34,tacticam,17,31,456,212,499,267,43,55,477.5,239.5,0.9025745987892151
34,tacticam,21,16,893,180,924,224,31,44,908.5,202.0,0.8940024971961975
34,tacticam,19,27,606,132,630,175,24,43,618.0,153.5,0.8834899663925171
34,tacticam,2,15,1696,343,1717,403,21,60,1706.5,373.0,0.8769011497497559
34,tacticam,4,20,927,223,952,268,25,45,939.5,245.5,0.874201238155365
34,tacticam,15,11,970,172,999,216,29,44,984.5,194.0,0.8737017512321472
35,broadcast,2,2,1492,694,1556,820,64,126,1524.0,757.0,0.925139307975769
35,broadcast,7,7,1591,451,1650,527,59,76,1620.5,489.0,0.9241901636123657
35,broadcast,3,3,685,685,733,805,48,120,709.0,745.0,0.9111154675483704
35,broadcast,5,5,999,529,1059,623,60,94,1029.0,576.0,0.909294605255127
35,broadcast,14,14,925,538,981,629,56,91,953.0,583.5,0.9071009159088135
35,broadcast,9,9,883,590,929,698,46,108,906.0,644.0,0.8999090790748596
35,broadcast,16,16,1315,479,1373,566,58,87,1344.0,522.5,0.8982115387916565
35,broadcast,18,18,1521,488,1574,582,53,94,1547.5,535.0,0.8885028958320618
35,broadcast,12,12,1594,559,1642,662,48,103,1618.0,610.5,0.8571892380714417
35,broadcast,17,17,1543,452,1573,512,30,60,1558.0,482.0,0.7323670983314514
35,tacticam,10,3,278,703,314,772,36,69,296.0,737.5,0.9217646718025208
35,tacticam,18,7,1487,252,1522,301,35,49,1504.5,276.5,0.9188346862792969
35,tacticam,7,29,1659,473,1691,533,32,60,1675.0,503.0,0.9174249172210693
35,tacticam,8,8,1333,788,1362,859,29,71,1347.5,823.5,0.9166150689125061
35,tacticam,17,31,463,215,500,268,37,53,481.5,241.5,0.9147764444351196
35,tacticam,2,15,1693,345,1720,405,27,60,1706.5,375.0,0.9111741185188293
35,tacticam,12,19,718,347,757,400,39,53,737.5,373.5,0.911124050617218
35,tacticam,1,9,330,478,364,535,34,57,347.0,506.5,0.9094783663749695
35,tacticam,13,10,758,387,798,440,40,53,778.0,413.5,0.9082140922546387
35,tacticam,16,4,760,260,791,310,31,50,775.5,285.0,0.9058690071105957
35,tacticam,6,22,1153,368,1181,421,28,53,1167.0,394.5,0.9012791514396667
35,tacticam,21,16,893,180,926,223,33,43,909.5,201.5,0.9012267589569092
35,tacticam,3,12,1102,481,1125,538,23,57,1113.5,509.5,0.8967717885971069
35,tacticam,14,5,1020,283,1045,340,25,57,1032.5,311.5,0.8901387453079224
35,tacticam,4,20,927,226,952,269,25,43,939.5,247.5,0.8763701319694519
35,tacticam,19,27,610,133,634,177,24,44,622.0,155.0,0.8585007190704346
36,broadcast,5,5,998,528,1064,619,66,91,1031.0,573.5,0.9227197766304016
36,broadcast,2,2,1486,691,1562,816,76,125,1524.0,753.5,0.91996169090271
36,broadcast,16,16,1315,479,1382,566,67,87,1348.5,522.5,0.9115729928016663
36,broadcast,14,14,929,540,987,630,58,90,958.0,585.0,0.9112731218338013
36,broadcast,9,9,881,588,935,698,54,110,908.0,643.0,0.9060817360877991
36,broadcast,3,3,686,684,735,806,49,122,710.5,745.0,0.9056334495544434
36,broadcast,18,18,1513,492,1574,580,61,88,1543.5,536.0,0.8939158916473389
36,broadcast,12,12,1597,595,1631,663,34,68,1614.0,629.0,0.7939087152481079
36,broadcast,17,17,1542,450,1575,514,33,64,1558.5,482.0,0.7526542544364929
36,broadcast,19,19,1598,561,1631,638,33,77,1614.5,599.5,0.7349519729614258
36,tacticam,10,3,280,697,321,770,41,73,300.5,733.5,0.9273045063018799
36,tacticam,7,29,1657,472,1692,533,35,61,1674.5,502.5,0.9237931370735168
36,tacticam,8,8,1334,785,1366,857,32,72,1350.0,821.0,0.9206016659736633
36,tacticam,15,11,967,175,994,218,27,43,980.5,196.5,0.9147472381591797
36,tacticam,14,5,1021,285,1051,341,30,56,1036.0,313.0,0.9133687615394592
36,tacticam,6,22,1157,368,1185,422,28,54,1171.0,395.0,0.9126238822937012
36,tacticam,16,4,756,260,794,308,38,48,775.0,284.0,0.9105310440063477
36,tacticam,18,7,1489,253,1521,303,32,50,1505.0,278.0,0.9093030691146851
36,tacticam,2,15,1688,345,1723,406,35,61,1705.5,375.5,0.9084982872009277
36,tacticam,1,9,333,476,366,534,33,58,349.5,505.0,0.9079349637031555
36,tacticam,20,17,798,175,827,220,29,45,812.5,197.5,0.9072339534759521
36,tacticam,13,10,762,387,799,440,37,53,780.5,413.5,0.9067251682281494
36,tacticam,3,12,1103,482,1126,538,23,56,1114.5,510.0,0.9065358638763428
36,tacticam,12,19,721,349,757,403,36,54,739.0,376.0,0.9035723805427551
36,tacticam,19,27,611,135,641,177,30,42,626.0,156.0,0.9021593928337097
36,tacticam,4,20,928,227,957,269,29,42,942.5,248.0,0.8818589448928833
36,tacticam,17,31,466,217,500,268,34,51,483.0,242.5,0.874903678894043
36,tacticam,11,14,348,400,388,450,40,50,368.0,425.0,0.8660892844200134
37,broadcast,2,2,1474,691,1567,809,93,118,1520.5,750.0,0.9363104104995728
37,broadcast,9,9,878,589,942,694,64,105,910.0,641.5,0.9176151156425476
37,broadcast,16,16,1319,480,1388,566,69,86,1353.5,523.0,0.9167715311050415
37,broadcast,5,5,1004,528,1065,618,61,90,1034.5,573.0,0.912037193775177
37,broadcast,18,18,1512,491,1570,582,58,91,1541.0,536.5,0.9040622115135193
37,broadcast,14,14,937,543,993,630,56,87,965.0,586.5,0.9001642465591431
37,broadcast,19,19,1593,561,1636,664,43,103,1614.5,612.5,0.8967611789703369
37,broadcast,3,3,688,682,737,791,49,109,712.5,736.5,0.8848261833190918
37,broadcast,15,15,367,512,405,615,38,103,386.0,563.5,0.7226046919822693
37,broadcast,17,17,1538,449,1574,526,36,77,1556.0,487.5,0.6554709076881409
37,tacticam,10,3,283,694,326,766,43,72,304.5,730.0,0.9425351619720459
37,tacticam,8,8,1334,783,1368,855,34,72,1351.0,819.0,0.9247061610221863
37,tacticam,7,29,1652,474,1694,534,42,60,1673.0,504.0,0.9240302443504333
37,tacticam,6,22,1155,370,1187,423,32,53,1171.0,396.5,0.9219346642494202
37,tacticam,17,31,469,218,500,270,31,52,484.5,244.0,0.9182335734367371
37,tacticam,1,9,337,473,373,534,36,61,355.0,503.5,0.9160088300704956
37,tacticam,14,5,1025,286,1057,342,32,56,1041.0,314.0,0.9152712225914001
37,tacticam,3,12,1103,481,1129,537,26,56,1116.0,509.0,0.9113026261329651
37,tacticam,2,15,1684,346,1724,406,40,60,1704.0,376.0,0.9099844694137573
37,tacticam,5,2,800,553,844,611,44,58,822.0,582.0,0.9071187376976013
37,tacticam,19,27,613,136,645,178,32,42,629.0,157.0,0.9060744047164917
37,tacticam,13,10,767,388,799,442,32,54,783.0,415.0,0.9045395255088806
37,tacticam,15,11,966,175,998,219,32,44,982.0,197.0,0.9018450975418091
37,tacticam,12,19,724,352,754,403,30,51,739.0,377.5,0.8987279534339905
37,tacticam,4,20,927,229,960,270,33,41,943.5,249.5,0.8950690627098083
37,tacticam,11,14,353,399,390,449,37,50,371.5,424.0,0.8823014497756958
37,tacticam,18,7,1490,256,1519,306,29,50,1504.5,281.0,0.8812859058380127
37,tacticam,9,21,347,370,388,424,41,54,367.5,397.0,0.8191133141517639
38,broadcast,9,9,877,589,946,694,69,105,911.5,641.5,0.9295257329940796
38,broadcast,5,5,1006,528,1068,621,62,93,1037.0,574.5,0.9126107096672058
38,broadcast,19,19,1588,559,1645,667,57,108,1616.5,613.0,0.9097180962562561
38,broadcast,14,14,946,544,998,632,52,88,972.0,588.0,0.9042441844940186
38,broadcast,3,3,691,679,740,801,49,122,715.5,740.0,0.8903335928916931
38,broadcast,18,18,1517,493,1564,584,47,91,1540.5,538.5,0.8788055181503296
38,broadcast,7,7,1584,454,1625,532,41,78,1604.5,493.0,0.7910981774330139
38,broadcast,17,17,1537,453,1575,534,38,81,1556.0,493.5,0.6782072186470032
38,broadcast,15,15,379,515,416,613,37,98,397.5,564.0,0.6286934614181519
38,tacticam,17,31,470,219,504,272,34,53,487.0,245.5,0.9290779829025269
38,tacticam,10,3,284,689,331,758,47,69,307.5,723.5,0.9259974360466003
38,tacticam,8,8,1334,781,1372,853,38,72,1353.0,817.0,0.924607515335083
38,tacticam,7,29,1653,474,1694,534,41,60,1673.5,504.0,0.9201866984367371
38,tacticam,14,5,1030,288,1063,343,33,55,1046.5,315.5,0.9181132316589355
38,tacticam,1,9,340,471,382,532,42,61,361.0,501.5,0.9149358868598938
38,tacticam,2,15,1683,348,1724,407,41,59,1703.5,377.5,0.9117004871368408
38,tacticam,6,22,1156,371,1190,423,34,52,1173.0,397.0,0.9096001982688904
38,tacticam,3,12,1102,480,1133,537,31,57,1117.5,508.5,0.9074916839599609
38,tacticam,15,11,964,177,999,219,35,42,981.5,198.0,0.9064878821372986
38,tacticam,21,16,895,186,928,229,33,43,911.5,207.5,0.9040764570236206
38,tacticam,19,27,615,137,650,180,35,43,632.5,158.5,0.9036813378334045
38,tacticam,20,17,795,179,821,223,26,44,808.0,201.0,0.9036036133766174
38,tacticam,16,4,752,262,791,310,39,48,771.5,286.0,0.8976454734802246
38,tacticam,5,2,796,554,839,611,43,57,817.5,582.5,0.8963191509246826
38,tacticam,13,10,770,388,797,442,27,54,783.5,415.0,0.8956188559532166
38,tacticam,12,19,723,351,751,403,28,52,737.0,377.0,0.8878872990608215
38,tacticam,18,7,1492,259,1516,306,24,47,1504.0,282.5,0.8841421604156494
38,tacticam,11,14,352,388,395,448,43,60,373.5,418.0,0.8813067078590393
38,tacticam,9,21,348,371,393,438,45,67,370.5,404.5,0.7698502540588379
39,broadcast,9,9,880,591,947,694,67,103,913.5,642.5,0.9276089668273926
39,broadcast,2,2,1464,691,1540,810,76,119,1502.0,750.5,0.9164640307426453
39,broadcast,16,16,1327,482,1396,565,69,83,1361.5,523.5,0.9161684513092041
39,broadcast,3,3,697,678,748,792,51,114,722.5,735.0,0.910643458366394
39,broadcast,19,19,1585,559,1652,666,67,107,1618.5,612.5,0.9101763963699341
39,broadcast,14,14,957,544,1006,631,49,87,981.5,587.5,0.8919714689254761
39,broadcast,5,5,1012,529,1073,622,61,93,1042.5,575.5,0.8684675693511963
39,broadcast,7,7,1584,455,1614,533,30,78,1599.0,494.0,0.8624307513237
39,broadcast,15,15,390,517,427,615,37,98,408.5,566.0,0.807166337966919
39,broadcast,18,18,1521,493,1564,584,43,91,1542.5,538.5,0.8019184470176697
39,broadcast,17,17,1535,458,1577,535,42,77,1556.0,496.5,0.7101706266403198
39,tacticam,14,5,1035,289,1066,344,31,55,1050.5,316.5,0.9260357618331909
39,tacticam,8,8,1332,781,1374,850,42,69,1353.0,815.5,0.925191342830658
39,tacticam,10,3,286,685,330,751,44,66,308.0,718.0,0.9241399765014648
39,tacticam,20,17,792,179,824,223,32,44,808.0,201.0,0.9216808080673218
39,tacticam,17,31,473,219,510,273,37,54,491.5,246.0,0.9190088510513306
39,tacticam,5,2,796,552,831,611,35,59,813.5,581.5,0.9189207553863525
39,tacticam,3,12,1101,479,1135,535,34,56,1118.0,507.0,0.9170544743537903
39,tacticam,1,9,342,469,386,526,44,57,364.0,497.5,0.9164838790893555
39,tacticam,12,19,722,351,754,404,32,53,738.0,377.5,0.9140037894248962
39,tacticam,2,15,1684,349,1724,409,40,60,1704.0,379.0,0.908286988735199
39,tacticam,7,29,1655,477,1690,535,35,58,1672.5,506.0,0.9079527258872986
39,tacticam,6,22,1158,373,1192,426,34,53,1175.0,399.5,0.9050601720809937
39,tacticam,13,10,772,387,793,443,21,56,782.5,415.0,0.8933942914009094
39,tacticam,18,7,1492,261,1513,309,21,48,1502.5,285.0,0.8881320357322693
39,tacticam,16,4,754,263,784,313,30,50,769.0,288.0,0.8870974183082581
39,tacticam,11,14,355,395,399,448,44,53,377.0,421.5,0.8738575577735901
39,tacticam,21,16,897,188,923,230,26,42,910.0,209.0,0.8703518509864807
39,tacticam,19,27,619,141,651,182,32,41,635.0,161.5,0.8671277761459351
40,broadcast,9,9,883,592,948,696,65,104,915.5,644.0,0.9252538681030273
40,broadcast,16,16,1333,483,1398,568,65,85,1365.5,525.5,0.9204833507537842
40,broadcast,19,19,1577,559,1657,661,80,102,1617.0,610.0,0.9193180203437805
40,broadcast,5,5,1020,527,1079,622,59,95,1049.5,574.5,0.9185888171195984
40,broadcast,3,3,697,677,752,788,55,111,724.5,732.5,0.9177666902542114
40,broadcast,2,2,1464,694,1532,812,68,118,1498.0,753.0,0.9132720232009888
40,broadcast,14,14,968,543,1013,630,45,87,990.5,586.5,0.9092305302619934
40,broadcast,7,7,1576,453,1617,534,41,81,1596.5,493.5,0.8747843503952026
40,broadcast,18,18,1517,494,1561,584,44,90,1539.0,539.0,0.8523952960968018
40,broadcast,17,17,1544,457,1573,535,29,78,1558.5,496.0,0.7060838341712952
40,tacticam,8,8,1333,781,1376,849,43,68,1354.5,815.0,0.9248625636100769
40,tacticam,17,31,479,219,516,272,37,53,497.5,245.5,0.9224581122398376
40,tacticam,3,12,1101,479,1136,535,35,56,1118.5,507.0,0.9221184849739075
40,tacticam,15,11,963,179,995,222,32,43,979.0,200.5,0.9208623766899109
40,tacticam,5,2,795,550,829,611,34,61,812.0,580.5,0.9200080633163452
40,tacticam,12,19,723,350,760,402,37,52,741.5,376.0,0.9149743318557739
40,tacticam,1,9,344,467,388,524,44,57,366.0,495.5,0.9135861396789551
40,tacticam,14,5,1041,289,1071,345,30,56,1056.0,317.0,0.912173867225647
40,tacticam,10,3,288,683,324,749,36,66,306.0,716.0,0.908190131187439
40,tacticam,7,29,1657,479,1686,535,29,56,1671.5,507.0,0.9026063084602356
40,tacticam,6,22,1164,373,1193,427,29,54,1178.5,400.0,0.901549220085144
40,tacticam,18,7,1492,262,1514,310,22,48,1503.0,286.0,0.8990236520767212
40,tacticam,2,15,1688,351,1721,409,33,58,1704.5,380.0,0.8976148962974548
40,tacticam,13,10,773,386,799,443,26,57,786.0,414.5,0.8948174715042114
40,tacticam,4,20,929,233,960,276,31,43,944.5,254.5,0.8936666250228882
40,tacticam,19,27,623,144,650,185,27,41,636.5,164.5,0.8810338377952576
40,tacticam,9,21,352,386,400,448,48,62,376.0,417.0,0.8684713244438171
40,tacticam,11,14,349,371,401,439,52,68,375.0,405.0,0.7202745079994202
41,broadcast,9,9,885,592,947,695,62,103,916.0,643.5,0.9230710864067078
41,broadcast,2,2,1460,694,1541,813,81,119,1500.5,753.5,0.9198659658432007
41,broadcast,16,16,1336,485,1393,567,57,82,1364.5,526.0,0.9115679264068604
41,broadcast,3,3,700,676,752,788,52,112,726.0,732.0,0.9110021591186523
41,broadcast,5,5,1023,527,1082,620,59,93,1052.5,573.5,0.9081252217292786
41,broadcast,19,19,1577,560,1658,659,81,99,1617.5,609.5,0.9062910079956055
41,broadcast,14,14,978,543,1022,629,44,86,1000.0,586.0,0.9053276777267456
41,broadcast,18,18,1510,492,1569,584,59,92,1539.5,538.0,0.9041222333908081
41,broadcast,7,7,1572,451,1620,532,48,81,1596.0,491.5,0.8593681454658508
41,broadcast,17,17,1543,458,1575,535,32,77,1559.0,496.5,0.6569451689720154
41,tacticam,10,3,289,681,320,749,31,68,304.5,715.0,0.9162374138832092
41,tacticam,14,5,1046,289,1073,344,27,55,1059.5,316.5,0.9157453179359436
41,tacticam,5,2,793,548,832,609,39,61,812.5,578.5,0.9146990180015564
41,tacticam,12,19,724,349,765,401,41,52,744.5,375.0,0.9141450524330139
41,tacticam,20,17,787,180,818,223,31,43,802.5,201.5,0.9124631881713867
41,tacticam,3,12,1104,480,1131,536,27,56,1117.5,508.0,0.9120330214500427
41,tacticam,17,31,481,219,521,272,40,53,501.0,245.5,0.9116607308387756
41,tacticam,8,8,1338,781,1376,847,38,66,1357.0,814.0,0.9113068580627441
41,tacticam,18,7,1493,261,1518,309,25,48,1505.5,285.0,0.9043287038803101
41,tacticam,7,29,1658,480,1683,535,25,55,1670.5,507.5,0.9017990827560425
41,tacticam,16,4,752,265,776,312,24,47,764.0,288.5,0.8970840573310852
41,tacticam,15,11,965,181,991,226,26,45,978.0,203.5,0.8969650268554688
41,tacticam,19,27,622,145,647,187,25,42,634.5,166.0,0.8917155265808105
41,tacticam,1,9,348,467,385,524,37,57,366.5,495.5,0.8895835280418396
41,tacticam,9,21,356,397,400,450,44,53,378.0,423.5,0.8880246877670288
41,tacticam,21,16,896,189,924,231,28,42,910.0,210.0,0.886824369430542
41,tacticam,6,22,1167,374,1191,427,24,53,1179.0,400.5,0.8818672895431519
41,tacticam,2,15,1693,352,1719,410,26,58,1706.0,381.0,0.8804965019226074
41,tacticam,13,10,774,385,801,442,27,57,787.5,413.5,0.8769737482070923
41,tacticam,4,20,931,234,955,276,24,42,943.0,255.0,0.8495683073997498
41,tacticam,23,33,549,105,582,145,33,40,565.5,125.0,0.7534087896347046
41,tacticam,11,14,350,370,380,421,30,51,365.0,395.5,0.6144377589225769
42,broadcast,9,9,889,591,942,696,53,105,915.5,643.5,0.9132952690124512
42,broadcast,2,2,1459,693,1527,814,68,121,1493.0,753.5,0.9131801724433899
42,broadcast,19,19,1579,562,1646,661,67,99,1612.5,611.5,0.908595085144043
42,broadcast,3,3,704,677,755,790,51,113,729.5,733.5,0.9039098620414734
42,broadcast,5,5,1028,526,1085,618,57,92,1056.5,572.0,0.8977512121200562
42,broadcast,18,18,1506,492,1573,583,67,91,1539.5,537.5,0.894512414932251
42,broadcast,14,14,989,542,1030,631,41,89,1009.5,586.5,0.8904272317886353
42,broadcast,16,16,1341,485,1387,557,46,72,1364.0,521.0,0.8138082027435303
42,broadcast,7,7,1538,465,1583,549,45,84,1560.5,507.0,0.7216479778289795
42,broadcast,20,20,1344,487,1393,567,49,80,1368.5,527.0,0.828446626663208
42,tacticam,5,2,790,547,835,605,45,58,812.5,576.0,0.9291083216667175
42,tacticam,16,4,747,266,781,311,34,45,764.0,288.5,0.9278417229652405
42,tacticam,18,7,1493,261,1521,310,28,49,1507.0,285.5,0.9185671806335449
42,tacticam,20,17,788,181,812,226,24,45,800.0,203.5,0.916387677192688
42,tacticam,7,29,1657,480,1682,537,25,57,1669.5,508.5,0.9054970741271973
42,tacticam,10,3,291,679,318,746,27,67,304.5,712.5,0.9053369760513306
42,tacticam,8,8,1337,781,1375,846,38,65,1356.0,813.5,0.9049636721611023
42,tacticam,1,9,350,467,383,525,33,58,366.5,496.0,0.9025506377220154
42,tacticam,3,12,1104,481,1126,537,22,56,1115.0,509.0,0.9022926688194275
42,tacticam,19,27,621,145,650,189,29,44,635.5,167.0,0.899114191532135
42,tacticam,14,5,1053,289,1075,343,22,54,1064.0,316.0,0.8967463970184326
42,tacticam,21,16,896,190,929,232,33,42,912.5,211.0,0.8957565426826477
42,tacticam,2,15,1695,353,1715,411,20,58,1705.0,382.0,0.8953354954719543
42,tacticam,13,10,773,384,807,439,34,55,790.0,411.5,0.8944387435913086
42,tacticam,9,21,356,395,395,451,39,56,375.5,423.0,0.8932514190673828
42,tacticam,6,22,1169,375,1190,427,21,52,1179.5,401.0,0.8777586817741394
42,tacticam,11,14,348,369,377,420,29,51,362.5,394.5,0.7800788879394531
43,broadcast,2,2,1463,690,1521,813,58,123,1492.0,751.5,0.9277915954589844
43,broadcast,3,3,711,674,759,789,48,115,735.0,731.5,0.9233831167221069
43,broadcast,9,9,896,590,939,696,43,106,917.5,643.0,0.9150014519691467
43,broadcast,19,19,1581,563,1644,665,63,102,1612.5,614.0,0.9126265048980713
43,broadcast,20,20,1345,487,1402,569,57,82,1373.5,528.0,0.8936173915863037
43,broadcast,14,14,998,543,1041,629,43,86,1019.5,586.0,0.8877745270729065
43,broadcast,5,5,1028,526,1091,611,63,85,1059.5,568.5,0.8855205774307251
43,broadcast,18,18,1545,476,1594,550,49,74,1569.5,513.0,0.8353164792060852
43,broadcast,17,17,1535,464,1582,550,47,86,1558.5,507.0,0.7244853377342224
43,tacticam,10,3,292,673,325,743,33,70,308.5,708.0,0.9396879076957703
43,tacticam,18,7,1491,262,1523,310,32,48,1507.0,286.0,0.9288329482078552
43,tacticam,5,2,786,545,834,603,48,58,810.0,574.0,0.9274695515632629
43,tacticam,7,29,1655,480,1686,536,31,56,1670.5,508.0,0.9154853820800781
43,tacticam,17,31,485,223,525,273,40,50,505.0,248.0,0.9139001369476318
43,tacticam,8,8,1337,780,1371,846,34,66,1354.0,813.0,0.908513605594635
43,tacticam,1,9,352,466,381,524,29,58,366.5,495.0,0.9082584977149963
43,tacticam,3,12,1103,481,1125,536,22,55,1114.0,508.5,0.9051045775413513
43,tacticam,13,10,774,384,811,439,37,55,792.5,411.5,0.900301992893219
43,tacticam,2,15,1694,352,1715,411,21,59,1704.5,381.5,0.8998991847038269
43,tacticam,12,19,725,349,764,401,39,52,744.5,375.0,0.8989641070365906
43,tacticam,4,20,931,235,958,277,27,42,944.5,256.0,0.8915775418281555
43,tacticam,15,11,961,181,986,226,25,45,973.5,203.5,0.8903935551643372
43,tacticam,9,21,364,397,395,451,31,54,379.5,424.0,0.889957070350647
43,tacticam,19,27,624,147,656,189,32,42,640.0,168.0,0.887639045715332
43,tacticam,6,22,1169,374,1189,427,20,53,1179.0,400.5,0.8552535176277161
43,tacticam,11,14,348,368,375,423,27,55,361.5,395.5,0.8470431566238403
43,tacticam,23,33,555,100,584,146,29,46,569.5,123.0,0.7106816172599792
44,broadcast,2,2,1466,689,1527,815,61,126,1496.5,752.0,0.9219980835914612
44,broadcast,9,9,899,589,945,697,46,108,922.0,643.0,0.9157212972640991
44,broadcast,3,3,716,670,764,788,48,118,740.0,729.0,0.9130616784095764
44,broadcast,20,20,1346,486,1409,571,63,85,1377.5,528.5,0.9113798141479492
44,broadcast,19,19,1578,565,1632,666,54,101,1605.0,615.5,0.8859080076217651
44,broadcast,7,7,1510,493,1572,578,62,85,1541.0,535.5,0.8853120803833008
44,broadcast,14,14,1009,541,1050,628,41,87,1029.5,584.5,0.880470335483551
44,broadcast,5,5,1040,527,1094,593,54,66,1067.0,560.0,0.8688313961029053
44,broadcast,17,17,1554,474,1602,550,48,76,1578.0,512.0,0.7545763850212097
44,broadcast,18,18,1565,447,1595,525,30,78,1580.0,486.0,0.647077202796936
44,broadcast,21,21,1537,466,1580,545,43,79,1558.5,505.5,0.7438294291496277
44,tacticam,5,2,788,546,828,602,40,56,808.0,574.0,0.9282117486000061
44,tacticam,7,29,1654,480,1687,537,33,57,1670.5,508.5,0.9232926964759827
44,tacticam,18,7,1489,264,1524,312,35,48,1506.5,288.0,0.9200297594070435
44,tacticam,10,3,293,670,331,736,38,66,312.0,703.0,0.9184234738349915
44,tacticam,3,12,1101,481,1129,536,28,55,1115.0,508.5,0.9151813387870789
44,tacticam,1,9,356,466,384,524,28,58,370.0,495.0,0.9105563759803772
44,tacticam,8,8,1337,777,1371,845,34,68,1354.0,811.0,0.9103837609291077
44,tacticam,13,10,779,384,811,436,32,52,795.0,410.0,0.9078530669212341
44,tacticam,19,27,625,149,658,191,33,42,641.5,170.0,0.9062225222587585
44,tacticam,20,17,785,184,811,229,26,45,798.0,206.5,0.9051860570907593
44,tacticam,4,20,931,236,963,278,32,42,947.0,257.0,0.9041555523872375
44,tacticam,2,15,1693,353,1719,412,26,59,1706.0,382.5,0.9036730527877808
44,tacticam,15,11,960,184,991,227,31,43,975.5,205.5,0.9007672667503357
44,tacticam,17,31,489,224,525,276,36,52,507.0,250.0,0.899203360080719
44,tacticam,6,22,1170,375,1195,428,25,53,1182.5,401.5,0.8976794481277466
44,tacticam,12,19,729,351,760,403,31,52,744.5,377.0,0.892026960849762
44,tacticam,11,14,348,368,376,425,28,57,362.0,396.5,0.8638970255851746
44,tacticam,9,21,366,395,397,450,31,55,381.5,422.5,0.856080949306488
45,broadcast,9,9,903,589,953,698,50,109,928.0,643.5,0.9162333011627197
45,broadcast,20,20,1347,485,1417,569,70,84,1382.0,527.0,0.9147367477416992
45,broadcast,2,2,1466,688,1529,809,63,121,1497.5,748.5,0.9130585789680481
45,broadcast,3,3,720,667,768,784,48,117,744.0,725.5,0.9029068946838379
45,broadcast,19,19,1577,564,1628,666,51,102,1602.5,615.0,0.8911792635917664
45,broadcast,7,7,1518,491,1565,584,47,93,1541.5,537.5,0.888376772403717
45,broadcast,14,14,1018,539,1060,629,42,90,1039.0,584.0,0.869648814201355
45,broadcast,5,5,1044,526,1088,593,44,67,1066.0,559.5,0.8288548588752747
45,broadcast,21,21,1539,468,1598,543,59,75,1568.5,505.5,0.782063364982605
45,broadcast,17,17,1552,460,1599,540,47,80,1575.5,500.0,0.604654848575592
45,tacticam,7,29,1652,480,1690,538,38,58,1671.0,509.0,0.9272520542144775
45,tacticam,16,4,740,267,776,313,36,46,758.0,290.0,0.9213138818740845
45,tacticam,3,12,1099,480,1132,534,33,54,1115.5,507.0,0.9212538003921509
45,tacticam,20,17,782,185,814,229,32,44,798.0,207.0,0.9151298403739929
45,tacticam,10,3,294,667,334,729,40,62,314.0,698.0,0.9145199656486511
45,tacticam,15,11,958,185,993,227,35,42,975.5,206.0,0.9121607542037964
45,tacticam,8,8,1337,774,1372,844,35,70,1354.5,809.0,0.9105494618415833
45,tacticam,6,22,1173,375,1198,428,25,53,1185.5,401.5,0.91020268201828
45,tacticam,18,7,1490,265,1524,313,34,48,1507.0,289.0,0.9100326299667358
45,tacticam,21,16,895,193,927,237,32,44,911.0,215.0,0.9096063375473022
45,tacticam,2,15,1689,353,1722,413,33,60,1705.5,383.0,0.9075301289558411
45,tacticam,1,9,358,463,391,522,33,59,374.5,492.5,0.9074544906616211
45,tacticam,4,20,930,238,964,279,34,41,947.0,258.5,0.9072900414466858
45,tacticam,13,10,783,384,811,436,28,52,797.0,410.0,0.9042733311653137
45,tacticam,5,2,789,545,822,601,33,56,805.5,573.0,0.9004452228546143
45,tacticam,9,21,365,397,401,447,36,50,383.0,422.0,0.8774930238723755
45,tacticam,11,14,349,370,377,428,28,58,363.0,399.0,0.8689907789230347
45,tacticam,12,19,731,352,757,403,26,51,744.0,377.5,0.8471089005470276
45,tacticam,17,31,494,226,521,276,27,50,507.5,251.0,0.8375287055969238
46,broadcast,2,2,1453,689,1531,808,78,119,1492.0,748.5,0.9182897210121155
46,broadcast,19,19,1579,562,1636,669,57,107,1607.5,615.5,0.914655864238739
46,broadcast,9,9,905,590,957,696,52,106,931.0,643.0,0.9141510128974915
46,broadcast,3,3,724,665,770,776,46,111,747.0,720.5,0.9036667943000793
46,broadcast,14,14,1027,537,1076,629,49,92,1051.5,583.0,0.8774591684341431
46,broadcast,7,7,1513,492,1558,586,45,94,1535.5,539.0,0.8143866062164307
46,broadcast,17,17,1549,457,1595,538,46,81,1572.0,497.5,0.7894514799118042
46,broadcast,5,5,1047,525,1088,602,41,77,1067.5,563.5,0.7790955901145935
46,broadcast,21,21,1542,466,1584,537,42,71,1563.0,501.5,0.7767350673675537
46,tacticam,7,29,1650,480,1690,537,40,57,1670.0,508.5,0.9287674427032471
46,tacticam,1,9,360,462,397,519,37,57,378.5,490.5,0.9263340830802917
46,tacticam,14,5,1068,292,1088,346,20,54,1078.0,319.0,0.9224534630775452
46,tacticam,3,12,1098,480,1134,532,36,52,1116.0,506.0,0.9205641746520996
46,tacticam,4,20,932,239,963,282,31,43,947.5,260.5,0.9185367822647095
46,tacticam,10,3,296,662,334,723,38,61,315.0,692.5,0.9183672666549683
46,tacticam,6,22,1174,376,1203,428,29,52,1188.5,402.0,0.9154079556465149
46,tacticam,8,8,1340,771,1375,843,35,72,1357.5,807.0,0.9151468873023987
46,tacticam,17,31,498,226,524,276,26,50,511.0,251.0,0.9074061512947083
46,tacticam,5,2,789,544,815,601,26,57,802.0,572.5,0.9066801071166992
46,tacticam,2,15,1686,355,1723,413,37,58,1704.5,384.0,0.9061917662620544
46,tacticam,13,10,787,385,809,435,22,50,798.0,410.0,0.9001272320747375
46,tacticam,16,4,742,267,771,314,29,47,756.5,290.5,0.8995264768600464
46,tacticam,19,27,629,153,660,193,31,40,644.5,173.0,0.8988437056541443
46,tacticam,18,7,1494,268,1521,316,27,48,1507.5,292.0,0.8935662508010864
46,tacticam,12,19,733,352,755,404,22,52,744.0,378.0,0.8897944092750549
46,tacticam,21,16,897,195,925,238,28,43,911.0,216.5,0.8845059275627136
46,tacticam,15,11,956,188,988,228,32,40,972.0,208.0,0.8725953102111816
46,tacticam,9,21,365,397,404,446,39,49,384.5,421.5,0.8707826733589172
46,tacticam,11,14,353,371,376,424,23,53,364.5,397.5,0.8562757968902588
47,broadcast,19,19,1580,562,1642,671,62,109,1611.0,616.5,0.9265681505203247
47,broadcast,2,2,1448,690,1531,808,83,118,1489.5,749.0,0.9263021349906921
47,broadcast,9,9,908,592,959,693,51,101,933.5,642.5,0.92038893699646
47,broadcast,3,3,728,665,773,776,45,111,750.5,720.5,0.9113453030586243
47,broadcast,17,17,1545,459,1598,545,53,86,1571.5,502.0,0.8843449354171753
47,broadcast,7,7,1509,495,1562,586,53,91,1535.5,540.5,0.8733803033828735
47,broadcast,14,14,1035,534,1087,630,52,96,1061.0,582.0,0.8693304061889648
47,tacticam,8,8,1340,769,1378,841,38,72,1359.0,805.0,0.9300082921981812
47,tacticam,7,29,1648,481,1690,538,42,57,1669.0,509.5,0.9285290241241455
47,tacticam,6,22,1174,377,1208,429,34,52,1191.0,403.0,0.9259929656982422
47,tacticam,4,20,934,241,962,285,28,44,948.0,263.0,0.9243703484535217
47,tacticam,3,12,1097,479,1134,533,37,54,1115.5,506.0,0.9198583960533142
47,tacticam,1,9,362,460,403,516,41,56,382.5,488.0,0.9134215712547302
47,tacticam,14,5,1068,292,1094,346,26,54,1081.0,319.0,0.9132448434829712
47,tacticam,10,3,296,661,331,721,35,60,313.5,691.0,0.9094429612159729
47,tacticam,5,2,786,542,820,600,34,58,803.0,571.0,0.9085121750831604
47,tacticam,17,31,502,227,529,276,27,49,515.5,251.5,0.9040783643722534
47,tacticam,16,4,740,267,765,316,25,49,752.5,291.5,0.9023755788803101
47,tacticam,13,10,789,385,809,437,20,52,799.0,411.0,0.9016281962394714
47,tacticam,2,15,1685,357,1724,414,39,57,1704.5,385.5,0.9015162587165833
47,tacticam,15,11,957,188,987,230,30,42,972.0,209.0,0.8961268067359924
47,tacticam,12,19,732,352,761,403,29,51,746.5,377.5,0.8864697217941284
47,tacticam,20,17,777,188,811,230,34,42,794.0,209.0,0.8776916265487671
47,tacticam,11,14,356,372,379,421,23,49,367.5,396.5,0.8233912587165833
47,tacticam,23,33,567,110,595,152,28,42,581.0,131.0,0.7995527982711792
48,broadcast,2,2,1448,692,1524,812,76,120,1486.0,752.0,0.9300525188446045
48,broadcast,19,19,1576,561,1646,665,70,104,1611.0,613.0,0.9136613607406616
48,broadcast,9,9,911,595,960,694,49,99,935.5,644.5,0.9095063209533691
48,broadcast,7,7,1513,494,1566,587,53,93,1539.5,540.5,0.896186351776123
48,broadcast,3,3,730,665,774,778,44,113,752.0,721.5,0.8925000429153442
48,broadcast,17,17,1544,458,1600,551,56,93,1572.0,504.5,0.880992591381073
48,broadcast,14,14,1042,540,1097,631,55,91,1069.5,585.5,0.866882860660553
48,broadcast,5,5,1037,533,1090,620,53,87,1063.5,576.5,0.7555558085441589
48,tacticam,8,8,1342,768,1380,839,38,71,1361.0,803.5,0.9405075907707214
48,tacticam,6,22,1176,379,1210,430,34,51,1193.0,404.5,0.9307363033294678
48,tacticam,10,3,297,657,329,720,32,63,313.0,688.5,0.9235304594039917
48,tacticam,14,5,1070,296,1100,348,30,52,1085.0,322.0,0.9189128875732422
48,tacticam,1,9,363,460,405,513,42,53,384.0,486.5,0.916844367980957
48,tacticam,3,12,1100,480,1132,534,32,54,1116.0,507.0,0.9164900779724121
48,tacticam,5,2,785,540,824,599,39,59,804.5,569.5,0.9160705208778381
48,tacticam,16,4,740,267,767,316,27,49,753.5,291.5,0.9150473475456238
48,tacticam,7,29,1651,483,1687,540,36,57,1669.0,511.5,0.9115423560142517
48,tacticam,13,10,789,385,814,437,25,52,801.5,411.0,0.9100350141525269
48,tacticam,12,19,732,351,765,403,33,52,748.5,377.0,0.9097222685813904
48,tacticam,2,15,1689,358,1725,416,36,58,1707.0,387.0,0.9042122960090637
48,tacticam,17,31,505,227,535,276,30,49,520.0,251.5,0.9033845663070679
48,tacticam,15,11,960,190,984,232,24,42,972.0,211.0,0.8911759257316589
48,tacticam,21,16,898,196,925,239,27,43,911.5,217.5,0.8119596242904663
49,broadcast,2,2,1448,695,1514,813,66,118,1481.0,754.0,0.9285807609558105
49,broadcast,19,19,1570,562,1647,665,77,103,1608.5,613.5,0.9199850559234619
49,broadcast,3,3,735,666,779,780,44,114,757.0,723.0,0.9036770462989807
49,broadcast,9,9,913,598,961,694,48,96,937.0,646.0,0.9022318720817566
49,broadcast,14,14,1051,542,1106,633,55,91,1078.5,587.5,0.8974250555038452
49,broadcast,17,17,1544,462,1592,536,48,74,1568.0,499.0,0.890500545501709
49,broadcast,7,7,1512,495,1570,584,58,89,1541.0,539.5,0.8894269466400146
49,broadcast,20,20,1354,501,1412,576,58,75,1383.0,538.5,0.8277366161346436
49,broadcast,5,5,1039,539,1083,616,44,77,1061.0,577.5,0.747271716594696
49,tacticam,10,3,298,653,334,718,36,65,316.0,685.5,0.9378007650375366
49,tacticam,8,8,1344,767,1382,837,38,70,1363.0,802.0,0.9314601421356201
49,tacticam,14,5,1074,295,1106,348,32,53,1090.0,321.5,0.9217289090156555
49,tacticam,6,22,1180,380,1212,432,32,52,1196.0,406.0,0.9208318591117859
49,tacticam,16,4,738,267,771,313,33,46,754.5,290.0,0.919499933719635
49,tacticam,12,19,732,351,771,402,39,51,751.5,376.5,0.9155722260475159
49,tacticam,13,10,790,384,820,435,30,51,805.0,409.5,0.9114272594451904
49,tacticam,17,31,509,228,541,277,32,49,525.0,252.5,0.9099521636962891
49,tacticam,1,9,368,459,404,512,36,53,386.0,485.5,0.909130871295929
49,tacticam,3,12,1101,481,1127,534,26,53,1114.0,507.5,0.9070950150489807
49,tacticam,2,15,1695,360,1723,417,28,57,1709.0,388.5,0.9042606353759766
49,tacticam,21,16,898,196,932,240,34,44,915.0,218.0,0.9042404890060425
49,tacticam,7,29,1654,484,1683,540,29,56,1668.5,512.0,0.8998849987983704
49,tacticam,19,27,631,159,662,200,31,41,646.5,179.5,0.8923422694206238
49,tacticam,9,21,368,397,407,451,39,54,387.5,424.0,0.8874555826187134
49,tacticam,11,14,358,371,380,421,22,50,369.0,396.0,0.8372223377227783
50,broadcast,2,2,1448,695,1505,814,57,119,1476.5,754.5,0.9200538992881775
50,broadcast,3,3,739,665,779,778,40,113,759.0,721.5,0.9090009331703186
50,broadcast,19,19,1572,566,1644,668,72,102,1608.0,617.0,0.9068180918693542
50,broadcast,9,9,914,600,962,697,48,97,938.0,648.5,0.9066172242164612
50,broadcast,14,14,1059,546,1116,635,57,89,1087.5,590.5,0.8928818702697754
50,broadcast,7,7,1511,497,1570,581,59,84,1540.5,539.0,0.888222873210907
50,broadcast,17,17,1542,464,1579,533,37,69,1560.5,498.5,0.8472927212715149
50,broadcast,5,5,1046,537,1107,624,61,87,1076.5,580.5,0.8203371167182922
50,broadcast,20,20,1369,505,1402,578,33,73,1385.5,541.5,0.8071348071098328
50,broadcast,16,16,1345,496,1399,572,54,76,1372.0,534.0,0.6730514764785767
50,tacticam,10,3,302,648,341,715,39,67,321.5,681.5,0.9396257996559143
50,tacticam,13,10,791,383,825,432,34,49,808.0,407.5,0.9274251461029053
50,tacticam,4,20,936,243,965,287,29,44,950.5,265.0,0.9220334887504578
50,tacticam,21,16,901,196,936,240,35,44,918.5,218.0,0.9216610789299011
50,tacticam,14,5,1082,296,1113,349,31,53,1097.5,322.5,0.9206044673919678
50,tacticam,19,27,635,160,670,202,35,42,652.5,181.0,0.9167333841323853
50,tacticam,17,31,513,228,549,278,36,50,531.0,253.0,0.912304699420929
50,tacticam,7,29,1655,484,1680,541,25,57,1667.5,512.5,0.91194748878479
50,tacticam,3,12,1102,482,1126,534,24,52,1114.0,508.0,0.907906174659729
50,tacticam,8,8,1349,767,1383,836,34,69,1366.0,801.5,0.9073712229728699
50,tacticam,16,4,737,267,773,311,36,44,755.0,289.0,0.9008773565292358
50,tacticam,15,11,959,190,985,233,26,43,972.0,211.5,0.8969193696975708
50,tacticam,2,15,1699,361,1720,416,21,55,1709.5,388.5,0.8936907649040222
50,tacticam,20,17,779,191,806,235,27,44,792.5,213.0,0.8893206119537354
50,tacticam,1,9,369,459,402,512,33,53,385.5,485.5,0.8838856816291809
50,tacticam,9,21,376,397,405,452,29,55,390.5,424.5,0.8802394270896912
50,tacticam,11,14,359,370,383,427,24,57,371.0,398.5,0.8799001574516296
50,tacticam,6,22,1186,382,1214,433,28,51,1200.0,407.5,0.8348649144172668
51,broadcast,2,2,1449,693,1500,816,51,123,1474.5,754.5,0.9190685749053955
51,broadcast,14,14,1069,548,1125,635,56,87,1097.0,591.5,0.9098407626152039
51,broadcast,9,9,917,600,964,697,47,97,940.5,648.5,0.9029006361961365
51,broadcast,7,7,1516,500,1569,581,53,81,1542.5,540.5,0.8956726789474487
51,broadcast,3,3,745,664,786,779,41,115,765.5,721.5,0.8917239904403687
51,broadcast,19,19,1575,570,1632,671,57,101,1603.5,620.5,0.891248881816864
51,broadcast,20,20,1371,509,1404,580,33,71,1387.5,544.5,0.8840327262878418
51,broadcast,16,16,1347,497,1389,548,42,51,1368.0,522.5,0.871850311756134
51,broadcast,5,5,1053,541,1094,615,41,74,1073.5,578.0,0.8298629522323608
51,broadcast,17,17,1543,466,1580,532,37,66,1561.5,499.0,0.8252159953117371
51,tacticam,10,3,305,643,349,708,44,65,327.0,675.5,0.9375187158584595
51,tacticam,4,20,939,245,970,286,31,41,954.5,265.5,0.9267094135284424
51,tacticam,17,31,515,230,554,278,39,48,534.5,254.0,0.9217623472213745
51,tacticam,1,9,373,458,404,511,31,53,388.5,484.5,0.9201828837394714
51,tacticam,21,16,900,198,935,241,35,43,917.5,219.5,0.9161617755889893
51,tacticam,8,8,1352,767,1381,834,29,67,1366.5,800.5,0.9159761667251587
51,tacticam,7,29,1655,484,1682,541,27,57,1668.5,512.5,0.9140945076942444
51,tacticam,14,5,1088,296,1119,349,31,53,1103.5,322.5,0.9140205383300781
51,tacticam,20,17,776,192,812,236,36,44,794.0,214.0,0.909928560256958
51,tacticam,3,12,1100,481,1131,535,31,54,1115.5,508.0,0.9088559746742249
51,tacticam,12,19,735,353,775,402,40,49,755.0,377.5,0.9077770709991455
51,tacticam,13,10,797,383,831,432,34,49,814.0,407.5,0.906325101852417
51,tacticam,18,7,1503,273,1528,321,25,48,1515.5,297.0,0.900687575340271
51,tacticam,15,11,960,190,990,233,30,43,975.0,211.5,0.8979278206825256
51,tacticam,9,21,380,398,414,455,34,57,397.0,426.5,0.8856368660926819
51,tacticam,11,14,358,370,388,426,30,56,373.0,398.0,0.8752803206443787
51,tacticam,6,22,1191,382,1214,431,23,49,1202.5,406.5,0.7966735363006592
52,broadcast,2,2,1448,692,1506,818,58,126,1477.0,755.0,0.9286991357803345
52,broadcast,9,9,915,599,972,697,57,98,943.5,648.0,0.9184220433235168
52,broadcast,3,3,748,664,794,770,46,106,771.0,717.0,0.9102959036827087
52,broadcast,14,14,1080,548,1135,636,55,88,1107.5,592.0,0.8891317844390869
52,broadcast,20,20,1364,510,1413,581,49,71,1388.5,545.5,0.8802165389060974
52,broadcast,19,19,1582,574,1624,672,42,98,1603.0,623.0,0.8744493126869202
52,broadcast,7,7,1520,502,1553,582,33,80,1536.5,542.0,0.8704687356948853
52,broadcast,5,5,1059,539,1103,615,44,76,1081.0,577.0,0.8420175313949585
52,broadcast,17,17,1541,470,1574,554,33,84,1557.5,512.0,0.8377649784088135
52,broadcast,15,15,526,534,568,626,42,92,547.0,580.0,0.6175041794776917
52,tacticam,10,3,307,639,351,699,44,60,329.0,669.0,0.9311593770980835
52,tacticam,3,12,1101,480,1135,530,34,50,1118.0,505.0,0.9217865467071533
52,tacticam,14,5,1094,297,1125,350,31,53,1109.5,323.5,0.9185272455215454
52,tacticam,1,9,375,455,410,510,35,55,392.5,482.5,0.9160144329071045
52,tacticam,7,29,1656,483,1685,541,29,58,1670.5,512.0,0.9106258749961853
52,tacticam,18,7,1502,273,1532,323,30,50,1517.0,298.0,0.9103988409042358
52,tacticam,17,31,518,232,558,281,40,49,538.0,256.5,0.9081593751907349
52,tacticam,8,8,1354,766,1379,832,25,66,1366.5,799.0,0.9070618748664856
52,tacticam,5,2,785,537,819,590,34,53,802.0,563.5,0.9059990644454956
52,tacticam,15,11,958,191,993,234,35,43,975.5,212.5,0.9053099155426025
52,tacticam,21,16,904,199,935,243,31,44,919.5,221.0,0.903485119342804
52,tacticam,13,10,799,383,834,432,35,49,816.5,407.5,0.9017104506492615
52,tacticam,16,4,736,267,769,314,33,47,752.5,290.5,0.9015600681304932
52,tacticam,2,15,1702,362,1723,418,21,56,1712.5,390.0,0.8957540988922119
52,tacticam,12,19,740,353,772,404,32,51,756.0,378.5,0.8949387073516846
52,tacticam,4,20,938,246,971,288,33,42,954.5,267.0,0.8921151757240295
52,tacticam,9,21,383,398,420,457,37,59,401.5,427.5,0.8909340500831604
52,tacticam,11,14,360,371,389,428,29,57,374.5,399.5,0.8781980276107788
53,broadcast,2,2,1445,692,1511,815,66,123,1478.0,753.5,0.9195738434791565
53,broadcast,9,9,913,598,980,699,67,101,946.5,648.5,0.9180652499198914
53,broadcast,3,3,752,663,796,766,44,103,774.0,714.5,0.9119535088539124
53,broadcast,14,14,1088,550,1145,636,57,86,1116.5,593.0,0.8866235017776489
53,broadcast,19,19,1581,574,1618,675,37,101,1599.5,624.5,0.8769437670707703
53,broadcast,20,20,1362,510,1421,582,59,72,1391.5,546.0,0.8732391595840454
53,broadcast,7,7,1519,502,1550,585,31,83,1534.5,543.5,0.8561039566993713
53,broadcast,17,17,1538,468,1577,555,39,87,1557.5,511.5,0.8483524322509766
53,broadcast,5,5,1064,541,1108,621,44,80,1086.0,581.0,0.8328970670700073
53,tacticam,10,3,311,636,348,697,37,61,329.5,666.5,0.9277506470680237
53,tacticam,3,12,1100,480,1136,530,36,50,1118.0,505.0,0.9249329566955566
53,tacticam,7,29,1656,483,1689,540,33,57,1672.5,511.5,0.9232814311981201
53,tacticam,13,10,804,383,836,432,32,49,820.0,407.5,0.9223508834838867
53,tacticam,1,9,377,453,417,508,40,55,397.0,480.5,0.9211519956588745
53,tacticam,5,2,782,535,816,591,34,56,799.0,563.0,0.9194599390029907
53,tacticam,2,15,1701,361,1728,420,27,59,1714.5,390.5,0.9158920645713806
53,tacticam,20,17,776,193,806,235,30,42,791.0,214.0,0.9157984256744385
53,tacticam,14,5,1102,298,1128,350,26,52,1115.0,324.0,0.9113678336143494
53,tacticam,9,21,381,401,420,455,39,54,400.5,428.0,0.9067290425300598
53,tacticam,15,11,958,193,991,234,33,41,974.5,213.5,0.9061602354049683
53,tacticam,18,7,1504,275,1534,322,30,47,1519.0,298.5,0.905558168888092
53,tacticam,8,8,1356,764,1381,832,25,68,1368.5,798.0,0.9040302634239197
53,tacticam,17,31,524,233,560,282,36,49,542.0,257.5,0.9031602144241333
53,tacticam,12,19,739,355,771,404,32,49,755.0,379.5,0.9010611176490784
53,tacticam,21,16,908,201,932,245,24,44,920.0,223.0,0.8880321383476257
53,tacticam,11,14,367,372,390,429,23,57,378.5,400.5,0.8747012615203857
53,tacticam,16,4,740,268,762,316,22,48,751.0,292.0,0.8562255501747131
53,tacticam,19,27,648,165,679,207,31,42,663.5,186.0,0.8320941925048828
54,broadcast,2,2,1434,693,1518,812,84,119,1476.0,752.5,0.931628942489624
54,broadcast,9,9,907,598,988,699,81,101,947.5,648.5,0.9211695790290833
54,broadcast,3,3,754,663,798,770,44,107,776.0,716.5,0.9129078388214111
54,broadcast,20,20,1359,503,1424,584,65,81,1391.5,543.5,0.9098089933395386
54,broadcast,19,19,1576,568,1622,675,46,107,1599.0,621.5,0.9039875864982605
54,broadcast,7,7,1514,502,1551,586,37,84,1532.5,544.0,0.9007927179336548
54,broadcast,14,14,1096,548,1149,637,53,89,1122.5,592.5,0.8940984606742859
54,broadcast,17,17,1535,467,1581,552,46,85,1558.0,509.5,0.8350716829299927
54,broadcast,5,5,1072,543,1109,615,37,72,1090.5,579.0,0.8286170959472656
54,tacticam,7,29,1654,483,1692,540,38,57,1673.0,511.5,0.9306634068489075
54,tacticam,5,2,782,532,814,591,32,59,798.0,561.5,0.9255070686340332
54,tacticam,3,12,1101,480,1136,530,35,50,1118.5,505.0,0.9246556162834167
54,tacticam,2,15,1699,362,1734,421,35,59,1716.5,391.5,0.9205964207649231
54,tacticam,10,3,316,634,345,697,29,63,330.5,665.5,0.920488715171814
54,tacticam,6,22,1199,382,1223,432,24,50,1211.0,407.0,0.9171184301376343
54,tacticam,8,8,1358,761,1387,830,29,69,1372.5,795.5,0.9146283268928528
54,tacticam,15,11,960,193,987,237,27,44,973.5,215.0,0.9084838032722473
54,tacticam,13,10,811,384,835,431,24,47,823.0,407.5,0.9084821343421936
54,tacticam,1,9,383,451,426,504,43,53,404.5,477.5,0.9018073081970215
54,tacticam,18,7,1505,277,1537,325,32,48,1521.0,301.0,0.8994117975234985
54,tacticam,17,31,529,236,564,282,35,46,546.5,259.0,0.8991535305976868
54,tacticam,14,5,1110,299,1133,350,23,51,1121.5,324.5,0.8984771966934204
54,tacticam,9,21,383,399,424,454,41,55,403.5,426.5,0.8935574293136597
54,tacticam,12,19,741,355,769,404,28,49,755.0,379.5,0.8912197947502136
54,tacticam,16,4,739,268,761,315,22,47,750.0,291.5,0.8874154686927795
54,tacticam,4,20,944,248,974,291,30,43,959.0,269.5,0.8766160607337952
54,tacticam,11,14,368,372,391,428,23,56,379.5,400.0,0.8757087588310242
55,broadcast,3,3,753,663,805,769,52,106,779.0,716.0,0.9216141700744629
55,broadcast,19,19,1571,566,1629,678,58,112,1600.0,622.0,0.9055957794189453
55,broadcast,14,14,1103,547,1154,637,51,90,1128.5,592.0,0.8962606191635132
55,broadcast,7,7,1510,502,1555,589,45,87,1532.5,545.5,0.8901791572570801
55,broadcast,5,5,1071,547,1114,616,43,69,1092.5,581.5,0.8660081028938293
55,broadcast,20,20,1365,507,1421,584,56,77,1393.0,545.5,0.858709990978241
55,broadcast,17,17,1536,494,1579,574,43,80,1557.5,534.0,0.7638099193572998
55,broadcast,21,21,1534,467,1555,519,21,52,1544.5,493.0,0.745914101600647
55,tacticam,2,15,1701,363,1738,421,37,58,1719.5,392.0,0.935425341129303
55,tacticam,5,2,782,530,819,589,37,59,800.5,559.5,0.9261756539344788
55,tacticam,10,3,320,632,346,695,26,63,333.0,663.5,0.9246687889099121
55,tacticam,7,29,1653,484,1695,541,42,57,1674.0,512.5,0.9241865873336792
55,tacticam,8,8,1361,759,1392,828,31,69,1376.5,793.5,0.9199724793434143
55,tacticam,6,22,1202,383,1229,432,27,49,1215.5,407.5,0.9186580181121826
55,tacticam,3,12,1102,480,1133,529,31,49,1117.5,504.5,0.9182044863700867
55,tacticam,16,4,740,267,767,315,27,48,753.5,291.0,0.9058988690376282
55,tacticam,9,21,386,401,426,453,40,52,406.0,427.0,0.9025990962982178
55,tacticam,17,31,533,236,563,282,30,46,548.0,259.0,0.8928619623184204
55,tacticam,12,19,745,353,774,403,29,50,759.5,378.0,0.8915704488754272
55,tacticam,18,7,1510,280,1539,327,29,47,1524.5,303.5,0.888934314250946
55,tacticam,21,16,912,201,935,245,23,44,923.5,223.0,0.8879454731941223
55,tacticam,11,14,370,372,395,423,25,51,382.5,397.5,0.8255749344825745
55,tacticam,4,20,948,249,974,294,26,45,961.0,271.5,0.8130987286567688
56,broadcast,2,2,1425,695,1517,810,92,115,1471.0,752.5,0.9394068121910095
56,broadcast,19,19,1567,568,1635,673,68,105,1601.0,620.5,0.9248839020729065
56,broadcast,9,9,907,599,988,701,81,102,947.5,650.0,0.9246485829353333
56,broadcast,3,3,752,662,812,769,60,107,782.0,715.5,0.9240293502807617
56,broadcast,20,20,1366,505,1414,585,48,80,1390.0,545.0,0.9191316962242126
56,broadcast,7,7,1501,501,1561,588,60,87,1531.0,544.5,0.903016984462738
56,broadcast,14,14,1108,547,1157,638,49,91,1132.5,592.5,0.8936151266098022
56,broadcast,5,5,1071,546,1120,616,49,70,1095.5,581.0,0.8812713027000427
56,broadcast,21,21,1528,467,1550,514,22,47,1539.0,490.5,0.7824983596801758
56,broadcast,17,17,1536,493,1575,573,39,80,1555.5,533.0,0.690870463848114
56,tacticam,10,3,324,628,353,692,29,64,338.5,660.0,0.9293443560600281
56,tacticam,6,22,1204,385,1235,433,31,48,1219.5,409.0,0.9265292882919312
56,tacticam,2,15,1703,366,1742,422,39,56,1722.5,394.0,0.9242656230926514
56,tacticam,5,2,783,529,823,586,40,57,803.0,557.5,0.9236935377120972
56,tacticam,7,29,1653,485,1696,541,43,56,1674.5,513.0,0.9228205680847168
56,tacticam,3,12,1102,481,1129,531,27,50,1115.5,506.0,0.9207818508148193
56,tacticam,16,4,739,269,771,313,32,44,755.0,291.0,0.919460654258728
56,tacticam,8,8,1361,758,1397,828,36,70,1379.0,793.0,0.919215977191925
56,tacticam,20,17,780,196,807,239,27,43,793.5,217.5,0.9125146865844727
56,tacticam,13,10,817,382,839,431,22,49,828.0,406.5,0.9096274375915527
56,tacticam,12,19,747,353,781,401,34,48,764.0,377.0,0.9065470695495605
56,tacticam,21,16,913,202,939,242,26,40,926.0,222.0,0.9001857042312622
56,tacticam,1,9,390,452,430,501,40,49,410.0,476.5,0.8994359970092773
56,tacticam,18,7,1517,282,1540,328,23,46,1528.5,305.0,0.8857394456863403
56,tacticam,17,31,536,236,564,283,28,47,550.0,259.5,0.8546956777572632
56,tacticam,9,21,395,401,424,452,29,51,409.5,426.5,0.8475625514984131
56,tacticam,11,14,373,372,397,420,24,48,385.0,396.0,0.8088801503181458
56,tacticam,4,20,950,250,973,295,23,45,961.5,272.5,0.6641094088554382
57,broadcast,2,2,1425,696,1508,813,83,117,1466.5,754.5,0.9335111975669861
57,broadcast,9,9,911,599,985,702,74,103,948.0,650.5,0.9237686395645142
57,broadcast,3,3,751,659,814,767,63,108,782.5,713.0,0.9138072729110718
57,broadcast,20,20,1367,505,1409,584,42,79,1388.0,544.5,0.9090210199356079
57,broadcast,14,14,1116,547,1157,637,41,90,1136.5,592.0,0.8944540619850159
57,broadcast,7,7,1492,501,1565,589,73,88,1528.5,545.0,0.8935887217521667
57,broadcast,5,5,1076,546,1124,618,48,72,1100.0,582.0,0.8726618885993958
57,broadcast,21,21,1521,468,1548,516,27,48,1534.5,492.0,0.6779245734214783
57,broadcast,17,17,1517,495,1572,583,55,88,1544.5,539.0,0.6347601413726807
57,broadcast,15,15,574,537,616,630,42,93,595.0,583.5,0.6170042157173157
57,tacticam,8,8,1361,758,1402,826,41,68,1381.5,792.0,0.9310445189476013
57,tacticam,10,3,327,624,361,687,34,63,344.0,655.5,0.9303383827209473
57,tacticam,3,12,1102,482,1135,529,33,47,1118.5,505.5,0.9288835525512695
57,tacticam,5,2,782,528,826,582,44,54,804.0,555.0,0.9260836243629456
57,tacticam,6,22,1208,385,1240,435,32,50,1224.0,410.0,0.913713276386261
57,tacticam,2,15,1711,368,1744,424,33,56,1727.5,396.0,0.913654088973999
57,tacticam,20,17,777,197,811,239,34,42,794.0,218.0,0.9099032282829285
57,tacticam,17,31,540,236,573,282,33,46,556.5,259.0,0.9051399230957031
57,tacticam,21,16,914,203,944,246,30,43,929.0,224.5,0.903950572013855
57,tacticam,12,19,750,353,786,401,36,48,768.0,377.0,0.902778685092926
57,tacticam,11,14,374,371,400,424,26,53,387.0,397.5,0.9024651050567627
57,tacticam,19,27,664,171,693,213,29,42,678.5,192.0,0.902355968952179
57,tacticam,13,10,821,381,845,431,24,50,833.0,406.0,0.9022473096847534
57,tacticam,7,29,1661,487,1696,543,35,56,1678.5,515.0,0.8963521122932434
57,tacticam,15,11,964,198,991,240,27,42,977.5,219.0,0.8934327363967896
57,tacticam,4,20,952,250,975,294,23,44,963.5,272.0,0.8901669979095459
57,tacticam,1,9,394,449,428,502,34,53,411.0,475.5,0.873248815536499
57,tacticam,9,21,398,401,423,451,25,50,410.5,426.0,0.8343762159347534
58,broadcast,19,19,1554,570,1636,669,82,99,1595.0,619.5,0.9314354062080383
58,broadcast,2,2,1423,698,1497,815,74,117,1460.0,756.5,0.9287002682685852
58,broadcast,20,20,1367,505,1416,585,49,80,1391.5,545.0,0.924684464931488
58,broadcast,9,9,914,599,975,702,61,103,944.5,650.5,0.9200716614723206
58,broadcast,3,3,751,658,814,760,63,102,782.5,709.0,0.9109391570091248
58,broadcast,14,14,1122,549,1163,637,41,88,1142.5,593.0,0.8929479122161865
58,broadcast,5,5,1082,546,1130,618,48,72,1106.0,582.0,0.8884258270263672
58,broadcast,15,15,581,538,624,632,43,94,602.5,585.0,0.8511150479316711
58,broadcast,21,21,1516,470,1545,518,29,48,1530.5,494.0,0.8270806074142456
58,broadcast,17,17,1530,495,1575,580,45,85,1552.5,537.5,0.7252775430679321
58,tacticam,3,12,1102,482,1140,530,38,48,1121.0,506.0,0.9359357953071594
58,tacticam,8,8,1363,758,1407,825,44,67,1385.0,791.5,0.9292469620704651
58,tacticam,6,22,1213,386,1244,436,31,50,1228.5,411.0,0.9214426279067993
58,tacticam,10,3,329,620,367,681,38,61,348.0,650.5,0.918601393699646
58,tacticam,15,11,965,197,993,239,28,42,979.0,218.0,0.9170687794685364
58,tacticam,13,10,824,380,850,429,26,49,837.0,404.5,0.916725218296051
58,tacticam,2,15,1714,370,1744,423,30,53,1729.0,396.5,0.91533362865448
58,tacticam,5,2,782,527,822,581,40,54,802.0,554.0,0.909686803817749
58,tacticam,12,19,749,352,788,399,39,47,768.5,375.5,0.9089532494544983
58,tacticam,21,16,914,204,946,248,32,44,930.0,226.0,0.9085561633110046
58,tacticam,4,20,953,249,981,294,28,45,967.0,271.5,0.9067713618278503
58,tacticam,17,31,545,236,580,283,35,47,562.5,259.5,0.9039060473442078
58,tacticam,11,14,376,372,401,423,25,51,388.5,397.5,0.901633620262146
58,tacticam,19,27,667,173,697,216,30,43,682.0,194.5,0.8860098123550415
58,tacticam,7,29,1665,488,1686,544,21,56,1675.5,516.0,0.868184506893158
58,tacticam,1,9,398,449,426,501,28,52,412.0,475.0,0.863006055355072
58,tacticam,9,21,401,398,426,450,25,52,413.5,424.0,0.8413820862770081
59,broadcast,20,20,1368,504,1421,586,53,82,1394.5,545.0,0.9287731051445007
59,broadcast,19,19,1555,572,1628,672,73,100,1591.5,622.0,0.922042191028595
59,broadcast,9,9,913,598,965,701,52,103,939.0,649.5,0.9102479815483093
59,broadcast,2,2,1423,698,1483,817,60,119,1453.0,757.5,0.9079676866531372
59,broadcast,3,3,752,657,809,756,57,99,780.5,706.5,0.9012253284454346
59,broadcast,14,14,1128,550,1168,640,40,90,1148.0,595.0,0.8869291543960571
59,broadcast,5,5,1089,546,1138,621,49,75,1113.5,583.5,0.8701285123825073
59,broadcast,17,17,1534,494,1567,570,33,76,1550.5,532.0,0.8373117446899414
59,broadcast,21,21,1504,469,1542,521,38,52,1523.0,495.0,0.8290714025497437
59,tacticam,10,3,331,618,367,674,36,56,349.0,646.0,0.915779173374176
59,tacticam,8,8,1369,758,1408,823,39,65,1388.5,790.5,0.9129779934883118
59,tacticam,4,20,954,251,985,295,31,44,969.5,273.0,0.910388171672821
59,tacticam,17,31,550,235,585,284,35,49,567.5,259.5,0.9101642370223999
59,tacticam,6,22,1219,388,1245,437,26,49,1232.0,412.5,0.9091070294380188
59,tacticam,16,4,738,269,774,315,36,46,756.0,292.0,0.9081112742424011
59,tacticam,5,2,784,527,818,582,34,55,801.0,554.5,0.9057024717330933
59,tacticam,11,14,378,372,402,423,24,51,390.0,397.5,0.9048714637756348
59,tacticam,15,11,964,199,996,240,32,41,980.0,219.5,0.9041585922241211
59,tacticam,21,16,915,205,947,249,32,44,931.0,227.0,0.9040026664733887
59,tacticam,1,9,402,446,428,501,26,55,415.0,473.5,0.9019821286201477
59,tacticam,20,17,777,198,810,241,33,43,793.5,219.5,0.8960304260253906
59,tacticam,2,15,1722,371,1744,424,22,53,1733.0,397.5,0.8924223780632019
59,tacticam,14,5,1137,302,1158,354,21,52,1147.5,328.0,0.8793985843658447
59,tacticam,13,10,826,380,854,429,28,49,840.0,404.5,0.8756551146507263
59,tacticam,9,21,401,396,431,447,30,51,416.0,421.5,0.8737837672233582
59,tacticam,19,27,670,175,700,217,30,42,685.0,196.0,0.8719480633735657
59,tacticam,12,19,754,351,784,399,30,48,769.0,375.0,0.8594856262207031
59,tacticam,7,29,1667,488,1692,544,25,56,1679.5,516.0,0.6966896057128906
60,broadcast,20,20,1367,504,1425,587,58,83,1396.0,545.5,0.9276592135429382
60,broadcast,2,2,1424,695,1472,816,48,121,1448.0,755.5,0.9161220192909241
60,broadcast,9,9,913,599,957,702,44,103,935.0,650.5,0.906854510307312
60,broadcast,14,14,1131,551,1174,640,43,89,1152.5,595.5,0.9035869240760803
60,broadcast,19,19,1560,573,1623,676,63,103,1591.5,624.5,0.9011992812156677
60,broadcast,3,3,751,656,800,758,49,102,775.5,707.0,0.88899165391922
60,broadcast,5,5,1098,547,1140,618,42,71,1119.0,582.5,0.8877794146537781
60,broadcast,7,7,1490,505,1544,589,54,84,1517.0,547.0,0.8491987586021423
60,broadcast,21,21,1499,468,1540,528,41,60,1519.5,498.0,0.8224505186080933
60,broadcast,15,15,597,543,639,634,42,91,618.0,588.5,0.6173291206359863
60,broadcast,17,17,1533,493,1571,571,38,78,1552.0,532.0,0.6080244183540344
60,tacticam,9,21,405,395,438,446,33,51,421.5,420.5,0.9242162108421326
60,tacticam,13,10,830,379,859,429,29,50,844.5,404.0,0.9153469204902649
60,tacticam,10,3,332,614,365,673,33,59,348.5,643.5,0.9152428507804871
60,tacticam,8,8,1373,758,1408,822,35,64,1390.5,790.0,0.9127757549285889
60,tacticam,1,9,405,446,435,499,30,53,420.0,472.5,0.9100297689437866
60,tacticam,17,31,553,236,590,285,37,49,571.5,260.5,0.90968918800354
60,tacticam,18,7,1524,285,1552,331,28,46,1538.0,308.0,0.908420979976654
60,tacticam,6,22,1223,388,1247,436,24,48,1235.0,412.0,0.9049451351165771
60,tacticam,5,2,784,526,813,581,29,55,798.5,553.5,0.9048445820808411
60,tacticam,16,4,743,268,769,317,26,49,756.0,292.5,0.8932998180389404
60,tacticam,11,14,382,373,407,425,25,52,394.5,399.0,0.8918957114219666
60,tacticam,21,16,920,205,945,251,25,46,932.5,228.0,0.8827798962593079
60,tacticam,19,27,672,175,699,221,27,46,685.5,198.0,0.8777272701263428
60,tacticam,14,5,1139,301,1165,354,26,53,1152.0,327.5,0.8370549082756042
60,tacticam,7,29,1667,488,1691,544,24,56,1679.0,516.0,0.7091483473777771
60,tacticam,12,19,757,353,782,403,25,50,769.5,378.0,0.6343679428100586
61,broadcast,2,2,1420,693,1476,816,56,123,1448.0,754.5,0.9291539192199707
61,broadcast,20,20,1368,503,1427,588,59,85,1397.5,545.5,0.9281497597694397
61,broadcast,14,14,1130,554,1181,641,51,87,1155.5,597.5,0.9101682305335999
61,broadcast,9,9,915,599,958,701,43,102,936.5,650.0,0.9091925024986267
61,broadcast,3,3,751,657,795,759,44,102,773.0,708.0,0.8961803913116455
61,broadcast,5,5,1105,545,1148,617,43,72,1126.5,581.0,0.895858645439148
61,broadcast,19,19,1563,575,1609,677,46,102,1586.0,626.0,0.8882184028625488
61,broadcast,15,15,603,545,646,634,43,89,624.5,589.5,0.8711617588996887
61,broadcast,21,21,1492,468,1537,525,45,57,1514.5,496.5,0.8544225692749023
61,broadcast,7,7,1494,503,1530,593,36,90,1512.0,548.0,0.8040450811386108
61,broadcast,17,17,1523,495,1568,574,45,79,1545.5,534.5,0.7367902994155884
61,tacticam,3,12,1101,484,1137,529,36,45,1119.0,506.5,0.9224197864532471
61,tacticam,18,7,1525,284,1556,331,31,47,1540.5,307.5,0.9167898893356323
61,tacticam,9,21,411,392,441,444,30,52,426.0,418.0,0.9160112142562866
61,tacticam,10,3,337,612,364,673,27,61,350.5,642.5,0.9148955941200256
61,tacticam,8,8,1375,757,1406,822,31,65,1390.5,789.5,0.9130741953849792
61,tacticam,1,9,408,444,443,497,35,53,425.5,470.5,0.9110793471336365
61,tacticam,14,5,1143,303,1172,355,29,52,1157.5,329.0,0.9104509353637695
61,tacticam,7,29,1666,488,1695,543,29,55,1680.5,515.5,0.9092029929161072
61,tacticam,4,20,956,253,990,297,34,44,973.0,275.0,0.9049038290977478
61,tacticam,2,15,1727,372,1748,427,21,55,1737.5,399.5,0.8989217877388
61,tacticam,5,2,786,526,812,581,26,55,799.0,553.5,0.8981077075004578
61,tacticam,15,11,967,201,995,243,28,42,981.0,222.0,0.8945878744125366
61,tacticam,17,31,558,236,596,286,38,50,577.0,261.0,0.8927499651908875
61,tacticam,13,10,835,379,859,429,24,50,847.0,404.0,0.8924731016159058
61,tacticam,11,14,385,375,409,424,24,49,397.0,399.5,0.8900131583213806
61,tacticam,12,19,760,353,782,402,22,49,771.0,377.5,0.7717236280441284
62,broadcast,2,2,1413,692,1476,815,63,123,1444.5,753.5,0.9350314140319824
62,broadcast,14,14,1129,556,1187,641,58,85,1158.0,598.5,0.917760968208313
62,broadcast,20,20,1368,503,1424,589,56,86,1396.0,546.0,0.916951596736908
62,broadcast,9,9,915,600,956,702,41,102,935.5,651.0,0.910648763179779
62,broadcast,3,3,750,654,793,756,43,102,771.5,705.0,0.901275098323822
62,broadcast,19,19,1557,573,1597,676,40,103,1577.0,624.5,0.8741573691368103
62,broadcast,15,15,609,545,653,634,44,89,631.0,589.5,0.8610236048698425
62,broadcast,5,5,1112,543,1154,618,42,75,1133.0,580.5,0.8591153621673584
62,broadcast,21,21,1488,468,1529,527,41,59,1508.5,497.5,0.85016268491745
62,broadcast,7,7,1492,502,1527,592,35,90,1509.5,547.0,0.8249274492263794
62,broadcast,17,17,1521,497,1569,566,48,69,1545.0,531.5,0.6938037872314453
62,tacticam,10,3,338,607,370,670,32,63,354.0,638.5,0.9271813035011292
62,tacticam,7,29,1667,488,1700,544,33,56,1683.5,516.0,0.9239600300788879
62,tacticam,8,8,1375,756,1403,821,28,65,1389.0,788.5,0.9216324090957642
62,tacticam,18,7,1526,286,1559,332,33,46,1542.5,309.0,0.9190194010734558
62,tacticam,3,12,1102,484,1130,528,28,44,1116.0,506.0,0.9168455004692078
62,tacticam,6,22,1230,388,1250,438,20,50,1240.0,413.0,0.9127019643783569
62,tacticam,5,2,785,524,818,580,33,56,801.5,552.0,0.9116973876953125
62,tacticam,16,4,741,269,767,316,26,47,754.0,292.5,0.9113604426383972
62,tacticam,20,17,781,202,808,243,27,41,794.5,222.5,0.9093799591064453
62,tacticam,2,15,1727,372,1752,427,25,55,1739.5,399.5,0.9064810276031494
62,tacticam,4,20,959,255,988,300,29,45,973.5,277.5,0.9037007093429565
62,tacticam,14,5,1149,305,1178,356,29,51,1163.5,330.5,0.902737021446228
62,tacticam,11,14,388,375,411,424,23,49,399.5,399.5,0.8980757594108582
62,tacticam,1,9,410,442,447,493,37,51,428.5,467.5,0.8931442499160767
62,tacticam,17,31,562,239,598,288,36,49,580.0,263.5,0.8870958089828491
62,tacticam,12,19,763,354,786,401,23,47,774.5,377.5,0.878233790397644
62,tacticam,9,21,419,392,444,441,25,49,431.5,416.5,0.6487481594085693
63,broadcast,2,2,1397,692,1473,814,76,122,1435.0,753.0,0.9356448650360107
63,broadcast,3,3,749,648,798,757,49,109,773.5,702.5,0.9217821955680847
63,broadcast,19,19,1541,573,1598,677,57,104,1569.5,625.0,0.9156766533851624
63,broadcast,9,9,914,601,957,702,43,101,935.5,651.5,0.9097983241081238
63,broadcast,20,20,1364,504,1418,587,54,83,1391.0,545.5,0.8934765458106995
63,broadcast,14,14,1132,556,1197,641,65,85,1164.5,598.5,0.8837953209877014
63,broadcast,15,15,617,545,660,633,43,88,638.5,589.0,0.8687416315078735
63,broadcast,21,21,1482,470,1523,523,41,53,1502.5,496.5,0.8555802702903748
63,broadcast,5,5,1121,541,1166,626,45,85,1143.5,583.5,0.8544781804084778
63,broadcast,7,7,1490,504,1526,594,36,90,1508.0,549.0,0.7800896763801575
63,tacticam,5,2,783,522,824,578,41,56,803.5,550.0,0.927838146686554
63,tacticam,8,8,1378,753,1408,820,30,67,1393.0,786.5,0.9267584681510925
63,tacticam,7,29,1665,488,1703,544,38,56,1684.0,516.0,0.9215671420097351
63,tacticam,18,7,1529,288,1561,333,32,45,1545.0,310.5,0.9204866886138916
63,tacticam,10,3,341,602,377,666,36,64,359.0,634.0,0.9188120365142822
63,tacticam,14,5,1156,304,1185,356,29,52,1170.5,330.0,0.9176257848739624
63,tacticam,2,15,1725,372,1756,428,31,56,1740.5,400.0,0.9124295115470886
63,tacticam,6,22,1233,387,1256,438,23,51,1244.5,412.5,0.9118301868438721
63,tacticam,3,12,1101,482,1133,530,32,48,1117.0,506.0,0.9108772873878479
63,tacticam,12,19,762,351,792,402,30,51,777.0,376.5,0.9094098210334778
63,tacticam,16,4,742,270,771,313,29,43,756.5,291.5,0.9067318439483643
63,tacticam,11,14,386,375,418,427,32,52,402.0,401.0,0.9059268236160278
63,tacticam,17,31,565,242,599,288,34,46,582.0,265.0,0.9053651094436646
63,tacticam,1,9,410,441,450,491,40,50,430.0,466.0,0.903917670249939
63,tacticam,19,27,683,181,713,224,30,43,698.0,202.5,0.9017354846000671
63,tacticam,13,10,841,381,862,431,21,50,851.5,406.0,0.8904265761375427
63,tacticam,9,21,421,390,453,440,32,50,437.0,415.0,0.8827416896820068
63,tacticam,21,16,924,207,950,252,26,45,937.0,229.5,0.8780137896537781
64,broadcast,19,19,1539,572,1603,676,64,104,1571.0,624.0,0.9344884753227234
64,broadcast,3,3,748,646,803,752,55,106,775.5,699.0,0.92795729637146
64,broadcast,2,2,1389,694,1469,813,80,119,1429.0,753.5,0.9276142120361328
64,broadcast,9,9,903,606,953,702,50,96,928.0,654.0,0.91219162940979
64,broadcast,14,14,1134,554,1204,643,70,89,1169.0,598.5,0.8926944732666016
64,broadcast,15,15,624,547,665,634,41,87,644.5,590.5,0.8581733107566833
64,broadcast,20,20,1369,510,1414,588,45,78,1391.5,549.0,0.8513088226318359
64,broadcast,5,5,1130,540,1167,621,37,81,1148.5,580.5,0.8301008343696594
64,broadcast,17,17,1518,502,1563,560,45,58,1540.5,531.0,0.8267655372619629
64,broadcast,21,21,1480,475,1518,542,38,67,1499.0,508.5,0.8113937973976135
64,broadcast,7,7,1483,504,1528,593,45,89,1505.5,548.5,0.8063303828239441
64,broadcast,22,22,1351,505,1412,579,61,74,1381.5,542.0,0.6938424706459045
64,tacticam,3,12,1103,481,1138,528,35,47,1120.5,504.5,0.9308778047561646
64,tacticam,8,8,1380,751,1412,819,32,68,1396.0,785.0,0.9294819235801697
64,tacticam,10,3,344,600,383,660,39,60,363.5,630.0,0.9247883558273315
64,tacticam,7,29,1662,489,1706,543,44,54,1684.0,516.0,0.9225984215736389
64,tacticam,2,15,1725,373,1761,429,36,56,1743.0,401.0,0.9222429990768433
64,tacticam,16,4,741,269,775,312,34,43,758.0,290.5,0.9186485409736633
64,tacticam,12,19,763,352,797,399,34,47,780.0,375.5,0.9145229458808899
64,tacticam,17,31,571,241,598,287,27,46,584.5,264.0,0.9126765131950378
64,tacticam,11,14,384,374,424,430,40,56,404.0,402.0,0.9097367525100708
64,tacticam,18,7,1533,291,1560,336,27,45,1546.5,313.5,0.9085314273834229
64,tacticam,19,27,685,182,717,226,32,44,701.0,204.0,0.907398521900177
64,tacticam,14,5,1162,306,1191,357,29,51,1176.5,331.5,0.9036979675292969
64,tacticam,9,21,428,386,461,440,33,54,444.5,413.0,0.9018549919128418
64,tacticam,1,9,413,440,450,492,37,52,431.5,466.0,0.9000526666641235
64,tacticam,13,10,844,379,867,429,23,50,855.5,404.0,0.898728609085083
64,tacticam,6,22,1237,387,1261,438,24,51,1249.0,412.5,0.8882566690444946
64,tacticam,21,16,927,208,955,253,28,45,941.0,230.5,0.8847542405128479
64,tacticam,15,11,971,203,994,247,23,44,982.5,225.0,0.8488627076148987
65,broadcast,2,2,1389,697,1458,814,69,117,1423.5,755.5,0.9335362315177917
65,broadcast,3,3,745,644,803,751,58,107,774.0,697.5,0.9232787489891052
65,broadcast,9,9,894,607,953,703,59,96,923.5,655.0,0.9175734519958496
65,broadcast,19,19,1540,571,1603,674,63,103,1571.5,622.5,0.9158393740653992
65,broadcast,14,14,1137,551,1210,643,73,92,1173.5,597.0,0.899979293346405
65,broadcast,15,15,630,546,673,636,43,90,651.5,591.0,0.8750823140144348
65,broadcast,21,21,1482,474,1508,529,26,55,1495.0,501.5,0.8066217303276062
65,broadcast,7,7,1467,506,1531,593,64,87,1499.0,549.5,0.7938136458396912
65,broadcast,17,17,1515,502,1560,581,45,79,1537.5,541.5,0.6833080053329468
65,tacticam,8,8,1381,749,1415,818,34,69,1398.0,783.5,0.9306477904319763
65,tacticam,6,22,1236,388,1265,440,29,52,1250.5,414.0,0.9279077649116516
65,tacticam,2,15,1728,375,1762,430,34,55,1745.0,402.5,0.9260786175727844
65,tacticam,3,12,1102,480,1138,526,36,46,1120.0,503.0,0.9256350994110107
65,tacticam,12,19,762,351,801,399,39,48,781.5,375.0,0.9251063466072083
65,tacticam,10,3,347,596,387,651,40,55,367.0,623.5,0.9187052845954895
65,tacticam,7,29,1665,491,1705,542,40,51,1685.0,516.5,0.916466474533081
65,tacticam,17,31,574,242,602,288,28,46,588.0,265.0,0.9147487282752991
65,tacticam,14,5,1169,305,1195,356,26,51,1182.0,330.5,0.9113987684249878
65,tacticam,11,14,384,375,424,432,40,57,404.0,403.5,0.9076664447784424
65,tacticam,13,10,847,379,873,429,26,50,860.0,404.0,0.9027095437049866
65,tacticam,9,21,432,384,465,435,33,51,448.5,409.5,0.8962509036064148
65,tacticam,20,17,780,203,807,244,27,41,793.5,223.5,0.8942049145698547
65,tacticam,1,9,414,441,447,491,33,50,430.5,466.0,0.8931809663772583
65,tacticam,15,11,970,204,999,246,29,42,984.5,225.0,0.8856778144836426
65,tacticam,19,27,689,185,717,227,28,42,703.0,206.0,0.8828166723251343
65,tacticam,4,20,964,256,988,300,24,44,976.0,278.0,0.8825390934944153
65,tacticam,21,16,926,209,958,253,32,44,942.0,231.0,0.8815791010856628
66,broadcast,2,2,1391,696,1447,816,56,120,1419.0,756.0,0.9349285364151001
66,broadcast,9,9,886,606,959,703,73,97,922.5,654.5,0.9186351895332336
66,broadcast,3,3,742,643,799,750,57,107,770.5,696.5,0.9171286225318909
66,broadcast,19,19,1537,571,1599,668,62,97,1568.0,619.5,0.8913412094116211
66,broadcast,14,14,1143,549,1211,641,68,92,1177.0,595.0,0.8909109234809875
66,broadcast,20,20,1376,515,1430,589,54,74,1403.0,552.0,0.8893313407897949
66,broadcast,21,21,1476,471,1503,529,27,58,1489.5,500.0,0.864192545413971
66,broadcast,17,17,1510,504,1552,577,42,73,1531.0,540.5,0.7809367179870605
66,broadcast,7,7,1462,509,1530,594,68,85,1496.0,551.5,0.7640712261199951
66,broadcast,15,15,637,547,682,637,45,90,659.5,592.0,0.6016172170639038
66,tacticam,8,8,1382,747,1419,815,37,68,1400.5,781.0,0.9321532249450684
66,tacticam,6,22,1237,388,1270,440,33,52,1253.5,414.0,0.9267807602882385
66,tacticam,17,31,581,242,609,287,28,45,595.0,264.5,0.9250785112380981
66,tacticam,3,12,1100,477,1137,526,37,49,1118.5,501.5,0.921878457069397
66,tacticam,2,15,1732,377,1762,431,30,54,1747.0,404.0,0.9196311831474304
66,tacticam,10,3,352,592,382,649,30,57,367.0,620.5,0.9168457984924316
66,tacticam,1,9,419,440,447,490,28,50,433.0,465.0,0.9073042273521423
66,tacticam,16,4,742,271,772,316,30,45,757.0,293.5,0.9044569134712219
66,tacticam,13,10,848,379,879,427,31,48,863.5,403.0,0.9040541052818298
66,tacticam,4,20,967,257,994,302,27,45,980.5,279.5,0.8952388167381287
66,tacticam,7,29,1664,492,1701,545,37,53,1682.5,518.5,0.8896819353103638
66,tacticam,19,27,691,188,718,231,27,43,704.5,209.5,0.8814444541931152
66,tacticam,15,11,968,204,1003,247,35,43,985.5,225.5,0.8686442375183105
66,tacticam,21,16,924,211,956,255,32,44,940.0,233.0,0.8644431233406067
66,tacticam,9,21,437,383,464,431,27,48,450.5,407.0,0.8608103394508362
66,tacticam,11,14,389,381,424,433,35,52,406.5,407.0,0.8598385453224182
67,broadcast,2,2,1389,696,1439,816,50,120,1414.0,756.0,0.9222824573516846
67,broadcast,3,3,739,643,792,749,53,106,765.5,696.0,0.9075358510017395
67,broadcast,14,14,1147,544,1211,642,64,98,1179.0,593.0,0.9036663174629211
67,broadcast,19,19,1535,573,1590,670,55,97,1562.5,621.5,0.8941055536270142
67,broadcast,21,21,1468,470,1499,538,31,68,1483.5,504.0,0.8890261650085449
67,broadcast,15,15,645,547,688,636,43,89,666.5,591.5,0.8618592619895935
67,broadcast,7,7,1458,509,1526,594,68,85,1492.0,551.5,0.8472720980644226
67,tacticam,8,8,1383,747,1421,813,38,66,1402.0,780.0,0.9299004673957825
67,tacticam,6,22,1242,391,1271,440,29,49,1256.5,415.5,0.9218543171882629
67,tacticam,1,9,422,437,453,489,31,52,437.5,463.0,0.9195758104324341
67,tacticam,10,3,355,590,381,649,26,59,368.0,619.5,0.9119642376899719
67,tacticam,2,15,1736,379,1761,432,25,53,1748.5,405.5,0.9052408337593079
67,tacticam,13,10,850,379,881,425,31,46,865.5,402.0,0.9019795060157776
67,tacticam,3,12,1100,476,1122,527,22,51,1111.0,501.5,0.9000920653343201
67,tacticam,17,31,584,243,617,290,33,47,600.5,266.5,0.8945193290710449
67,tacticam,9,21,444,382,466,428,22,46,455.0,405.0,0.8882620930671692
67,tacticam,7,29,1665,492,1699,545,34,53,1682.0,518.5,0.8854852914810181
67,tacticam,11,14,397,383,423,431,26,48,410.0,407.0,0.8850964903831482
67,tacticam,4,20,966,259,997,302,31,43,981.5,280.5,0.8824684023857117
67,tacticam,19,27,693,189,718,232,25,43,705.5,210.5,0.8758730888366699
67,tacticam,21,16,929,213,954,257,25,44,941.5,235.0,0.8700149059295654
68,broadcast,9,9,889,605,967,705,78,100,928.0,655.0,0.9275253415107727
68,broadcast,14,14,1150,542,1208,642,58,100,1179.0,592.0,0.9167556166648865
68,broadcast,2,2,1386,695,1435,816,49,121,1410.5,755.5,0.9133290648460388
68,broadcast,3,3,736,642,788,751,52,109,762.0,696.5,0.9077348113059998
68,broadcast,7,7,1453,509,1523,597,70,88,1488.0,553.0,0.8778827786445618
68,broadcast,15,15,653,546,696,636,43,90,674.5,591.0,0.8715559840202332
68,broadcast,21,21,1463,470,1496,535,33,65,1479.5,502.5,0.8568586111068726
68,broadcast,17,17,1511,503,1559,582,48,79,1535.0,542.5,0.7614297866821289
68,broadcast,19,19,1534,576,1580,669,46,93,1557.0,622.5,0.7535687685012817
68,broadcast,22,22,1342,515,1393,579,51,64,1367.5,547.0,0.7395176291465759
68,broadcast,23,23,1534,600,1580,674,46,74,1557.0,637.0,0.7909172177314758
68,tacticam,8,8,1387,747,1421,811,34,64,1404.0,779.0,0.9240505695343018
68,tacticam,1,9,423,435,460,488,37,53,441.5,461.5,0.9234590530395508
68,tacticam,2,15,1740,380,1760,433,20,53,1750.0,406.5,0.920635998249054
68,tacticam,17,31,587,243,622,291,35,48,604.5,267.0,0.9163947701454163
68,tacticam,10,3,358,588,382,648,24,60,370.0,618.0,0.9157664775848389
68,tacticam,6,22,1247,392,1272,441,25,49,1259.5,416.5,0.9126322269439697
68,tacticam,3,12,1099,477,1121,526,22,49,1110.0,501.5,0.9009312987327576
68,tacticam,5,2,771,519,813,571,42,52,792.0,545.0,0.8961086273193359
68,tacticam,12,19,768,352,799,402,31,50,783.5,377.0,0.8936103582382202
68,tacticam,13,10,854,379,884,426,30,47,869.0,402.5,0.8818384408950806
68,tacticam,19,27,696,189,720,233,24,44,708.0,211.0,0.8799447417259216
68,tacticam,20,17,779,207,805,247,26,40,792.0,227.0,0.8666719794273376
68,tacticam,11,14,401,379,421,432,20,53,411.0,405.5,0.8374378085136414
68,tacticam,7,29,1667,493,1693,547,26,54,1680.0,520.0,0.8361629843711853
68,tacticam,15,11,970,208,996,250,26,42,983.0,229.0,0.827420711517334
69,broadcast,2,2,1382,698,1436,816,54,118,1409.0,757.0,0.9245818257331848
69,broadcast,9,9,894,604,958,706,64,102,926.0,655.0,0.9162581562995911
69,broadcast,3,3,733,640,790,748,57,108,761.5,694.0,0.9127581715583801
69,broadcast,7,7,1461,515,1520,597,59,82,1490.5,556.0,0.9108468294143677
69,broadcast,14,14,1154,543,1206,641,52,98,1180.0,592.0,0.882779598236084
69,broadcast,19,19,1538,577,1579,676,41,99,1558.5,626.5,0.8819047212600708
69,broadcast,21,21,1453,469,1493,547,40,78,1473.0,508.0,0.8581783771514893
69,broadcast,17,17,1519,500,1565,575,46,75,1542.0,537.5,0.8196383118629456
69,broadcast,22,22,1343,518,1394,589,51,71,1368.5,553.5,0.7518828511238098
69,broadcast,5,5,1174,541,1211,639,37,98,1192.5,590.0,0.7421209812164307
69,tacticam,1,9,426,432,465,483,39,51,445.5,457.5,0.9371544122695923
69,tacticam,8,8,1389,747,1419,810,30,63,1404.0,778.5,0.9233105778694153
69,tacticam,17,31,589,244,625,292,36,48,607.0,268.0,0.9135429263114929
69,tacticam,5,2,770,516,813,571,43,55,791.5,543.5,0.9132044911384583
69,tacticam,10,3,359,584,388,644,29,60,373.5,614.0,0.912982165813446
69,tacticam,11,14,400,379,425,432,25,53,412.5,405.5,0.9117639064788818
69,tacticam,3,12,1097,476,1124,525,27,49,1110.5,500.5,0.9078050255775452
69,tacticam,6,22,1249,392,1271,441,22,49,1260.0,416.5,0.9044920802116394
69,tacticam,18,7,1543,294,1565,340,22,46,1554.0,317.0,0.9037187099456787
69,tacticam,20,17,774,207,808,248,34,41,791.0,227.5,0.8961759209632874
69,tacticam,13,10,859,379,883,427,24,48,871.0,403.0,0.8924526572227478
69,tacticam,12,19,770,352,796,401,26,49,783.0,376.5,0.8890430331230164
69,tacticam,19,27,696,190,724,233,28,43,710.0,211.5,0.8860774040222168
69,tacticam,16,4,742,272,767,317,25,45,754.5,294.5,0.8858362436294556
69,tacticam,4,20,964,262,1000,306,36,44,982.0,284.0,0.8812514543533325
69,tacticam,9,21,446,377,473,429,27,52,459.5,403.0,0.8578035235404968
70,broadcast,2,2,1376,691,1440,817,64,126,1408.0,754.0,0.9336922764778137
70,broadcast,9,9,897,603,947,705,50,102,922.0,654.0,0.9210677742958069
70,broadcast,3,3,733,639,791,746,58,107,762.0,692.5,0.9162864685058594
70,broadcast,7,7,1462,515,1518,597,56,82,1490.0,556.0,0.9111177325248718
70,broadcast,19,19,1534,576,1568,676,34,100,1551.0,626.0,0.9091620445251465
70,broadcast,17,17,1527,497,1569,568,42,71,1548.0,532.5,0.9066746234893799
70,broadcast,21,21,1451,472,1489,544,38,72,1470.0,508.0,0.8792784810066223
70,broadcast,14,14,1159,541,1207,644,48,103,1183.0,592.5,0.8761327862739563
70,broadcast,15,15,669,548,711,636,42,88,690.0,592.0,0.7939035296440125
70,broadcast,5,5,1191,540,1217,629,26,89,1204.0,584.5,0.778205394744873
70,broadcast,22,22,1348,520,1395,584,47,64,1371.5,552.0,0.6935713291168213
70,tacticam,1,9,427,432,465,480,38,48,446.0,456.0,0.937371015548706
70,tacticam,10,3,360,580,393,638,33,58,376.5,609.0,0.9271116256713867
70,tacticam,2,15,1741,380,1761,434,20,54,1751.0,407.0,0.9261518120765686
70,tacticam,3,12,1094,474,1127,524,33,50,1110.5,499.0,0.9200373291969299
70,tacticam,18,7,1540,294,1569,342,29,48,1554.5,318.0,0.9198995232582092
70,tacticam,8,8,1391,746,1415,807,24,61,1403.0,776.5,0.919888436794281
70,tacticam,11,14,400,378,429,428,29,50,414.5,403.0,0.9173690676689148
70,tacticam,17,31,592,246,627,294,35,48,609.5,270.0,0.9103533029556274
70,tacticam,19,27,696,192,725,235,29,43,710.5,213.5,0.9022493362426758
70,tacticam,16,4,740,272,771,315,31,43,755.5,293.5,0.9018095135688782
70,tacticam,12,19,770,353,794,401,24,48,782.0,377.0,0.8988531231880188
70,tacticam,7,29,1667,487,1694,548,27,61,1680.5,517.5,0.8886576890945435
70,tacticam,9,21,451,376,480,424,29,48,465.5,400.0,0.8714781403541565
70,tacticam,4,20,968,263,997,307,29,44,982.5,285.0,0.83819979429245
71,broadcast,2,2,1363,690,1443,814,80,124,1403.0,752.0,0.9287092685699463
71,broadcast,3,3,732,639,787,741,55,102,759.5,690.0,0.9270426630973816
71,broadcast,9,9,897,603,943,704,46,101,920.0,653.5,0.9109339118003845
71,broadcast,19,19,1528,574,1569,679,41,105,1548.5,626.5,0.8953424096107483
71,broadcast,14,14,1164,539,1206,639,42,100,1185.0,589.0,0.8838863372802734
71,broadcast,21,21,1450,476,1486,550,36,74,1468.0,513.0,0.8664295673370361
71,broadcast,15,15,678,553,720,638,42,85,699.0,595.5,0.8606563806533813
71,broadcast,17,17,1537,495,1573,569,36,74,1555.0,532.0,0.8544551134109497
71,broadcast,7,7,1468,522,1513,596,45,74,1490.5,559.0,0.8062831163406372
71,broadcast,5,5,1195,537,1225,628,30,91,1210.0,582.5,0.7681073546409607
71,broadcast,22,22,1353,521,1393,576,40,55,1373.0,548.5,0.6383769512176514
71,tacticam,3,12,1090,474,1128,523,38,49,1109.0,498.5,0.9248740673065186
71,tacticam,10,3,363,577,397,633,34,56,380.0,605.0,0.9248127341270447
71,tacticam,1,9,427,431,465,481,38,50,446.0,456.0,0.9222856760025024
71,tacticam,11,14,399,378,432,424,33,46,415.5,401.0,0.9208781719207764
71,tacticam,18,7,1539,296,1570,342,31,46,1554.5,319.0,0.9192941784858704
71,tacticam,16,4,736,272,771,315,35,43,753.5,293.5,0.9139700531959534
71,tacticam,8,8,1391,743,1413,808,22,65,1402.0,775.5,0.9130380153656006
71,tacticam,21,16,931,217,957,259,26,42,944.0,238.0,0.9083462953567505
71,tacticam,19,27,693,192,724,237,31,45,708.5,214.5,0.9070795178413391
71,tacticam,12,19,770,352,798,402,28,50,784.0,377.0,0.9060720205307007
71,tacticam,17,31,594,248,628,295,34,47,611.0,271.5,0.904862642288208
71,tacticam,14,5,1193,310,1215,361,22,51,1204.0,335.5,0.8979502320289612
71,tacticam,2,15,1739,380,1765,435,26,55,1752.0,407.5,0.8975480794906616
71,tacticam,7,29,1666,490,1696,547,30,57,1681.0,518.5,0.8915109634399414
71,tacticam,15,11,967,211,993,254,26,43,980.0,232.5,0.8584981560707092
71,tacticam,9,21,455,374,483,421,28,47,469.0,397.5,0.7554759979248047
72,broadcast,2,2,1355,690,1444,811,89,121,1399.5,750.5,0.9319701194763184
72,broadcast,3,3,731,639,780,740,49,101,755.5,689.5,0.9313772916793823
72,broadcast,19,19,1524,572,1572,677,48,105,1548.0,624.5,0.9085805416107178
72,broadcast,17,17,1542,494,1591,578,49,84,1566.5,536.0,0.8992359638214111
72,broadcast,9,9,896,604,943,703,47,99,919.5,653.5,0.8887697458267212
72,broadcast,21,21,1453,477,1484,551,31,74,1468.5,514.0,0.8726783990859985
72,broadcast,14,14,1170,538,1210,642,40,104,1190.0,590.0,0.8663701415061951
72,broadcast,15,15,684,556,727,638,43,82,705.5,597.0,0.8292726874351501
72,broadcast,7,7,1472,536,1508,597,36,61,1490.0,566.5,0.8126420974731445
72,broadcast,5,5,1199,540,1232,636,33,96,1215.5,588.0,0.805446207523346
72,broadcast,20,20,1473,511,1506,589,33,78,1489.5,550.0,0.714149534702301
72,tacticam,12,19,769,351,801,399,32,48,785.0,375.0,0.9200503826141357
72,tacticam,10,3,365,574,395,628,30,54,380.0,601.0,0.9181035161018372
72,tacticam,8,8,1392,742,1417,806,25,64,1404.5,774.0,0.9159861207008362
72,tacticam,2,15,1736,381,1768,436,32,55,1752.0,408.5,0.9148858785629272
72,tacticam,1,9,431,431,459,481,28,50,445.0,456.0,0.9133465886116028
72,tacticam,18,7,1541,297,1573,343,32,46,1557.0,320.0,0.9131866097450256
72,tacticam,21,16,930,217,961,260,31,43,945.5,238.5,0.9126586318016052
72,tacticam,14,5,1192,310,1220,362,28,52,1206.0,336.0,0.9092085361480713
72,tacticam,3,12,1088,474,1126,522,38,48,1107.0,498.0,0.9073892831802368
72,tacticam,19,27,693,194,722,239,29,45,707.5,216.5,0.9063276648521423
72,tacticam,11,14,403,377,434,425,31,48,418.5,401.0,0.9043657183647156
72,tacticam,17,31,594,250,627,295,33,45,610.5,272.5,0.9037659168243408
72,tacticam,13,10,865,376,886,427,21,51,875.5,401.5,0.8881164193153381
72,tacticam,15,11,966,211,995,254,29,43,980.5,232.5,0.8785761594772339
72,tacticam,7,29,1664,491,1696,545,32,54,1680.0,518.0,0.8749195337295532
73,broadcast,2,2,1353,691,1444,810,91,119,1398.5,750.5,0.9376621842384338
73,broadcast,19,19,1520,572,1579,677,59,105,1549.5,624.5,0.9161984920501709
73,broadcast,3,3,730,639,770,743,40,104,750.0,691.0,0.9150939583778381
73,broadcast,9,9,895,604,944,703,49,99,919.5,653.5,0.9064977765083313
73,broadcast,17,17,1546,492,1599,573,53,81,1572.5,532.5,0.8877311944961548
73,broadcast,14,14,1176,539,1211,641,35,102,1193.5,590.0,0.8764352202415466
73,broadcast,5,5,1204,534,1239,631,35,97,1221.5,582.5,0.8637382984161377
73,broadcast,15,15,693,562,735,639,42,77,714.0,600.5,0.8567147254943848
73,broadcast,21,21,1446,476,1479,552,33,76,1462.5,514.0,0.8544237017631531
73,broadcast,20,20,1475,510,1507,596,32,86,1491.0,553.0,0.853224515914917
73,tacticam,12,19,767,350,803,396,36,46,785.0,373.0,0.9269545674324036
73,tacticam,6,22,1255,393,1280,441,25,48,1267.5,417.0,0.9145445823669434
73,tacticam,14,5,1196,310,1224,361,28,51,1210.0,335.5,0.9119249582290649
73,tacticam,13,10,865,374,890,425,25,51,877.5,399.5,0.9117707014083862
73,tacticam,16,4,733,272,767,316,34,44,750.0,294.0,0.9116184115409851
73,tacticam,2,15,1736,381,1771,436,35,55,1753.5,408.5,0.9106012582778931
73,tacticam,18,7,1543,299,1573,345,30,46,1558.0,322.0,0.9078234434127808
73,tacticam,17,31,594,249,625,295,31,46,609.5,272.0,0.9061393141746521
73,tacticam,7,29,1659,491,1689,544,30,53,1674.0,517.5,0.9059513211250305
73,tacticam,3,12,1086,473,1119,522,33,49,1102.5,497.5,0.9048861861228943
73,tacticam,1,9,432,431,454,481,22,50,443.0,456.0,0.904684841632843
73,tacticam,11,14,407,375,432,425,25,50,419.5,400.0,0.9046111702919006
73,tacticam,8,8,1392,739,1420,805,28,66,1406.0,772.0,0.903965175151825
73,tacticam,10,3,364,571,391,628,27,57,377.5,599.5,0.9035018682479858
73,tacticam,21,16,926,217,955,259,29,42,940.5,238.0,0.8915446996688843
74,broadcast,2,2,1352,694,1438,812,86,118,1395.0,753.0,0.9402697086334229
74,broadcast,3,3,729,638,768,743,39,105,748.5,690.5,0.922778844833374
74,broadcast,19,19,1513,572,1576,667,63,95,1544.5,619.5,0.9108274579048157
74,broadcast,22,22,1368,519,1427,592,59,73,1397.5,555.5,0.9071846604347229
74,broadcast,9,9,887,606,944,704,57,98,915.5,655.0,0.9024269580841064
74,broadcast,21,21,1441,472,1479,552,38,80,1460.0,512.0,0.8986337184906006
74,broadcast,20,20,1473,508,1509,594,36,86,1491.0,551.0,0.8924987316131592
74,broadcast,5,5,1209,532,1246,632,37,100,1227.5,582.0,0.8725690841674805
74,broadcast,14,14,1179,539,1217,641,38,102,1198.0,590.0,0.8650885820388794
74,broadcast,15,15,702,562,743,637,41,75,722.5,599.5,0.8482005000114441
74,tacticam,6,22,1253,393,1282,441,29,48,1267.5,417.0,0.9286227822303772
74,tacticam,2,15,1739,382,1772,437,33,55,1755.5,409.5,0.9187612533569336
74,tacticam,14,5,1198,311,1228,361,30,50,1213.0,336.0,0.91813063621521
74,tacticam,10,3,363,568,390,626,27,58,376.5,597.0,0.9147234559059143
74,tacticam,8,8,1389,737,1421,803,32,66,1405.0,770.0,0.9142186641693115
74,tacticam,17,31,594,249,625,295,31,46,609.5,272.0,0.911293089389801
74,tacticam,1,9,432,430,456,480,24,50,444.0,455.0,0.9093891978263855
74,tacticam,13,10,863,372,892,425,29,53,877.5,398.5,0.9033393859863281
74,tacticam,7,29,1655,491,1685,545,30,54,1670.0,518.0,0.9032244086265564
74,tacticam,12,19,765,351,799,396,34,45,782.0,373.5,0.9030585885047913
74,tacticam,20,17,769,211,796,251,27,40,782.5,231.0,0.9002840518951416
74,tacticam,3,12,1086,474,1112,522,26,48,1099.0,498.0,0.8960318565368652
74,tacticam,11,14,407,374,430,425,23,51,418.5,399.5,0.8809337615966797
74,tacticam,4,20,971,265,996,308,25,43,983.5,286.5,0.8592351675033569
75,broadcast,3,3,727,638,776,739,49,101,751.5,688.5,0.9176973104476929
75,broadcast,2,2,1359,694,1432,812,73,118,1395.5,753.0,0.911469578742981
75,broadcast,9,9,879,608,944,705,65,97,911.5,656.5,0.9111772775650024
75,broadcast,19,19,1511,573,1578,669,67,96,1544.5,621.0,0.9103266000747681
75,broadcast,20,20,1472,505,1514,595,42,90,1493.0,550.0,0.903676450252533
75,broadcast,21,21,1440,474,1479,554,39,80,1459.5,514.0,0.8934404253959656
75,broadcast,5,5,1217,532,1255,637,38,105,1236.0,584.5,0.8752087354660034
75,broadcast,14,14,1180,542,1220,641,40,99,1200.0,591.5,0.8638432621955872
75,broadcast,15,15,709,565,751,640,42,75,730.0,602.5,0.8031764626502991
75,tacticam,6,22,1252,394,1281,440,29,46,1266.5,417.0,0.9229598045349121
75,tacticam,8,8,1385,735,1423,802,38,67,1404.0,768.5,0.9210891127586365
75,tacticam,10,3,364,565,395,625,31,60,379.5,595.0,0.9194169044494629
75,tacticam,2,15,1740,384,1771,437,31,53,1755.5,410.5,0.9187387228012085
75,tacticam,14,5,1201,313,1231,362,30,49,1216.0,337.5,0.9173070788383484
75,tacticam,19,27,693,200,721,241,28,41,707.0,220.5,0.9114242792129517
75,tacticam,13,10,864,372,892,422,28,50,878.0,397.0,0.9090681076049805
75,tacticam,5,2,761,511,800,563,39,52,780.5,537.0,0.9081708788871765
75,tacticam,4,20,967,265,997,311,30,46,982.0,288.0,0.9077663421630859
75,tacticam,3,12,1080,473,1104,523,24,50,1092.0,498.0,0.9069726467132568
75,tacticam,17,31,594,250,629,295,35,45,611.5,272.5,0.9010142087936401
75,tacticam,7,29,1657,492,1682,547,25,55,1669.5,519.5,0.8948482275009155
75,tacticam,1,9,432,428,459,481,27,53,445.5,454.5,0.8910543322563171
75,tacticam,12,19,766,352,796,397,30,45,781.0,374.5,0.8908513188362122
75,tacticam,11,14,406,373,429,423,23,50,417.5,398.0,0.888404369354248
75,tacticam,9,21,464,368,493,414,29,46,478.5,391.0,0.7217888832092285
75,tacticam,24,34,4,336,25,390,21,54,14.5,363.0,0.863795816898346
76,broadcast,9,9,875,610,945,705,70,95,910.0,657.5,0.9286280274391174
76,broadcast,2,2,1360,694,1423,811,63,117,1391.5,752.5,0.9226669073104858
76,broadcast,19,19,1510,574,1571,670,61,96,1540.5,622.0,0.9221669435501099
76,broadcast,20,20,1468,504,1519,593,51,89,1493.5,548.5,0.9083491563796997
76,broadcast,14,14,1179,543,1227,642,48,99,1203.0,592.5,0.901109516620636
76,broadcast,3,3,721,635,782,739,61,104,751.5,687.0,0.9005961418151855
76,broadcast,5,5,1229,533,1263,633,34,100,1246.0,583.0,0.8848563432693481
76,broadcast,21,21,1437,472,1481,553,44,81,1459.0,512.5,0.8753275871276855
76,broadcast,17,17,1556,492,1611,570,55,78,1583.5,531.0,0.8601846098899841
76,broadcast,15,15,720,564,761,643,41,79,740.5,603.5,0.7579707503318787
76,tacticam,10,3,363,561,397,622,34,61,380.0,591.5,0.9262785315513611
76,tacticam,8,8,1383,735,1424,799,41,64,1403.5,767.0,0.9218508005142212
76,tacticam,6,22,1253,395,1283,442,30,47,1268.0,418.5,0.9199795126914978
76,tacticam,19,27,692,200,724,243,32,43,708.0,221.5,0.9190137982368469
76,tacticam,5,2,760,510,797,562,37,52,778.5,536.0,0.9156361818313599
76,tacticam,14,5,1205,313,1232,362,27,49,1218.5,337.5,0.9144497513771057
76,tacticam,2,15,1743,386,1770,437,27,51,1756.5,411.5,0.9135689735412598
76,tacticam,3,12,1079,472,1106,523,27,51,1092.5,497.5,0.9094158411026001
76,tacticam,4,20,965,267,998,311,33,44,981.5,289.0,0.9057447910308838
76,tacticam,1,9,431,426,463,478,32,52,447.0,452.0,0.9056087732315063
76,tacticam,13,10,867,373,892,421,25,48,879.5,397.0,0.8972859382629395
76,tacticam,11,14,404,370,433,423,29,53,418.5,396.5,0.8960974216461182
76,tacticam,12,19,769,352,793,398,24,46,781.0,375.0,0.8958339691162109
76,tacticam,7,29,1660,493,1683,547,23,54,1671.5,520.0,0.8895458579063416
76,tacticam,16,4,729,271,754,317,25,46,741.5,294.0,0.8863343000411987
76,tacticam,24,34,12,336,32,390,20,54,22.0,363.0,0.8586246967315674
76,tacticam,9,21,465,367,494,409,29,42,479.5,388.0,0.721612274646759
77,broadcast,9,9,874,610,949,705,75,95,911.5,657.5,0.9293797016143799
77,broadcast,14,14,1183,543,1236,642,53,99,1209.5,592.5,0.9139164686203003
77,broadcast,2,2,1367,692,1419,812,52,120,1393.0,752.0,0.9063290357589722
77,broadcast,19,19,1513,576,1569,672,56,96,1541.0,624.0,0.9052188396453857
77,broadcast,3,3,724,637,780,733,56,96,752.0,685.0,0.9025298357009888
77,broadcast,5,5,1240,535,1273,635,33,100,1256.5,585.0,0.8922432661056519
77,broadcast,20,20,1469,505,1526,592,57,87,1497.5,548.5,0.8870986700057983
77,broadcast,21,21,1434,471,1481,551,47,80,1457.5,511.0,0.8595603704452515
77,broadcast,17,17,1561,495,1616,586,55,91,1588.5,540.5,0.826712429523468
77,broadcast,15,15,731,564,773,650,42,86,752.0,607.0,0.8229450583457947
77,tacticam,10,3,365,559,398,613,33,54,381.5,586.0,0.9225142002105713
77,tacticam,5,2,761,508,799,559,38,51,780.0,533.5,0.9160583019256592
77,tacticam,3,12,1074,470,1106,519,32,49,1090.0,494.5,0.914659857749939
77,tacticam,16,4,727,271,756,316,29,45,741.5,293.5,0.9136828184127808
77,tacticam,1,9,430,423,460,472,30,49,445.0,447.5,0.9128977060317993
77,tacticam,8,8,1388,735,1424,798,36,63,1406.0,766.5,0.911693811416626
77,tacticam,6,22,1256,396,1282,442,26,46,1269.0,419.0,0.9094517230987549
77,tacticam,4,20,965,268,998,313,33,45,981.5,290.5,0.9039552211761475
77,tacticam,12,19,768,352,790,398,22,46,779.0,375.0,0.8979362845420837
77,tacticam,2,15,1744,386,1768,439,24,53,1756.0,412.5,0.8973173499107361
77,tacticam,11,14,405,368,436,417,31,49,420.5,392.5,0.8969212770462036
77,tacticam,14,5,1210,312,1234,363,24,51,1222.0,337.5,0.8882830142974854
77,tacticam,20,17,760,211,785,251,25,40,772.5,231.0,0.8574178814888
78,broadcast,20,20,1472,506,1533,593,61,87,1502.5,549.5,0.9205266237258911
78,broadcast,3,3,729,631,776,732,47,101,752.5,681.5,0.9137418270111084
78,broadcast,14,14,1190,543,1246,642,56,99,1218.0,592.5,0.9111043810844421
78,broadcast,17,17,1570,497,1625,595,55,98,1597.5,546.0,0.9038596749305725
78,broadcast,2,2,1375,690,1421,812,46,122,1398.0,751.0,0.9007060527801514
78,broadcast,19,19,1521,575,1572,672,51,97,1546.5,623.5,0.8908724188804626
78,broadcast,5,5,1252,535,1285,635,33,100,1268.5,585.0,0.8783099055290222
78,broadcast,21,21,1437,473,1479,538,42,65,1458.0,505.5,0.8572388887405396
78,broadcast,15,15,745,563,784,641,39,78,764.5,602.0,0.7635707855224609
78,tacticam,10,3,363,556,396,607,33,51,379.5,581.5,0.923991858959198
78,tacticam,5,2,764,506,801,557,37,51,782.5,531.5,0.9234904050827026
78,tacticam,1,9,426,423,464,472,38,49,445.0,447.5,0.9200257658958435
78,tacticam,3,12,1069,470,1105,517,36,47,1087.0,493.5,0.9181197881698608
78,tacticam,16,4,724,270,759,313,35,43,741.5,291.5,0.9159063696861267
78,tacticam,19,27,692,204,726,245,34,41,709.0,224.5,0.9131702184677124
78,tacticam,8,8,1390,736,1422,798,32,62,1406.0,767.0,0.9094903469085693
78,tacticam,11,14,402,367,440,416,38,49,421.0,391.5,0.9060214757919312
78,tacticam,7,29,1660,493,1680,547,20,54,1670.0,520.0,0.8979511857032776
78,tacticam,4,20,967,270,996,313,29,43,981.5,291.5,0.8971475958824158
78,tacticam,18,7,1546,301,1568,347,22,46,1557.0,324.0,0.8859831690788269
78,tacticam,14,5,1214,313,1237,364,23,51,1225.5,338.5,0.8748696446418762
79,broadcast,2,2,1380,687,1427,812,47,125,1403.5,749.5,0.9166125655174255
79,broadcast,3,3,735,627,774,731,39,104,754.5,679.0,0.9115440249443054
79,broadcast,14,14,1203,541,1260,642,57,101,1231.5,591.5,0.91023850440979
79,broadcast,20,20,1480,507,1534,597,54,90,1507.0,552.0,0.9047001004219055
79,broadcast,5,5,1263,534,1299,636,36,102,1281.0,585.0,0.8965773582458496
79,broadcast,19,19,1516,575,1572,673,56,98,1544.0,624.0,0.8741891384124756
79,broadcast,21,21,1442,475,1485,541,43,66,1463.5,508.0,0.8422073125839233
79,broadcast,17,17,1581,501,1627,580,46,79,1604.0,540.5,0.8058833479881287
79,tacticam,18,7,1545,301,1571,347,26,46,1558.0,324.0,0.9157007336616516
79,tacticam,12,19,765,350,790,397,25,47,777.5,373.5,0.9151341319084167
79,tacticam,10,3,362,553,391,607,29,54,376.5,580.0,0.9133055210113525
79,tacticam,7,29,1658,493,1683,547,25,54,1670.5,520.0,0.9087396264076233
79,tacticam,8,8,1390,736,1420,798,30,62,1405.0,767.0,0.9067076444625854
79,tacticam,1,9,425,423,464,472,39,49,444.5,447.5,0.9059181213378906
79,tacticam,15,11,954,216,982,257,28,41,968.0,236.5,0.903175950050354
79,tacticam,21,16,924,223,951,264,27,41,937.5,243.5,0.8949757814407349
79,tacticam,19,27,692,205,723,246,31,41,707.5,225.5,0.8941824436187744
79,tacticam,11,14,401,367,435,414,34,47,418.0,390.5,0.8923537731170654
79,tacticam,2,15,1749,386,1769,439,20,53,1759.0,412.5,0.8915975689888
79,tacticam,3,12,1065,469,1099,517,34,48,1082.0,493.0,0.8913988471031189
79,tacticam,9,21,466,360,494,402,28,42,480.0,381.0,0.7754632234573364
80,broadcast,2,2,1378,686,1433,809,55,123,1405.5,747.5,0.9268336296081543
80,broadcast,9,9,897,605,978,705,81,100,937.5,655.0,0.9235022664070129
80,broadcast,14,14,1217,541,1273,643,56,102,1245.0,592.0,0.9176778793334961
80,broadcast,3,3,740,625,782,731,42,106,761.0,678.0,0.9111558198928833
80,broadcast,19,19,1521,573,1570,673,49,100,1545.5,623.0,0.8944410085678101
80,broadcast,5,5,1280,536,1314,636,34,100,1297.0,586.0,0.8932766914367676
80,broadcast,20,20,1492,509,1539,597,47,88,1515.5,553.0,0.8899328112602234
80,broadcast,17,17,1593,501,1641,597,48,96,1617.0,549.0,0.8660004734992981
80,broadcast,21,21,1451,477,1489,549,38,72,1470.0,513.0,0.8267093896865845
80,tacticam,7,29,1658,491,1686,546,28,55,1672.0,518.5,0.9194984436035156
80,tacticam,8,8,1391,734,1417,797,26,63,1404.0,765.5,0.9130387902259827
80,tacticam,12,19,764,349,793,395,29,46,778.5,372.0,0.9117124676704407
80,tacticam,17,31,596,252,633,297,37,45,614.5,274.5,0.9110925793647766
80,tacticam,1,9,426,423,460,470,34,47,443.0,446.5,0.910327136516571
80,tacticam,10,3,360,551,386,606,26,55,373.0,578.5,0.909875214099884
80,tacticam,18,7,1545,301,1575,347,30,46,1560.0,324.0,0.9024694561958313
80,tacticam,13,10,871,367,895,416,24,49,883.0,391.5,0.9017150402069092
80,tacticam,2,15,1749,386,1772,439,23,53,1760.5,412.5,0.9010210037231445
80,tacticam,11,14,403,364,433,415,30,51,418.0,389.5,0.8946210741996765
80,tacticam,21,16,920,223,953,264,33,41,936.5,243.5,0.8732642531394958
80,tacticam,9,21,467,356,496,400,29,44,481.5,378.0,0.8707513809204102
80,tacticam,3,12,1067,469,1092,518,25,49,1079.5,493.5,0.8347362875938416
81,broadcast,2,2,1377,688,1440,809,63,121,1408.5,748.5,0.9224604368209839
81,broadcast,14,14,1233,538,1284,641,51,103,1258.5,589.5,0.9164852499961853
81,broadcast,3,3,746,624,789,729,43,105,767.5,676.5,0.9071545600891113
81,broadcast,9,9,912,605,977,705,65,100,944.5,655.0,0.9038960337638855
81,broadcast,5,5,1295,537,1330,638,35,101,1312.5,587.5,0.9012268781661987
81,broadcast,19,19,1534,571,1585,673,51,102,1559.5,622.0,0.892029345035553
81,broadcast,17,17,1605,502,1658,598,53,96,1631.5,550.0,0.8889265656471252
81,broadcast,20,20,1508,511,1546,597,38,86,1527.0,554.0,0.8849506974220276
81,broadcast,21,21,1461,478,1491,542,30,64,1476.0,510.0,0.8807668089866638
81,tacticam,7,29,1654,490,1688,545,34,55,1671.0,517.5,0.9276258945465088
81,tacticam,10,3,356,548,383,604,27,56,369.5,576.0,0.9173294305801392
81,tacticam,2,15,1746,385,1776,439,30,54,1761.0,412.0,0.9134745001792908
81,tacticam,12,19,758,347,795,394,37,47,776.5,370.5,0.9131690263748169
81,tacticam,8,8,1390,732,1417,797,27,65,1403.5,764.5,0.9122294783592224
81,tacticam,13,10,870,366,895,413,25,47,882.5,389.5,0.9042723178863525
81,tacticam,18,7,1545,301,1577,346,32,45,1561.0,323.5,0.9012821316719055
81,tacticam,16,4,714,272,746,316,32,44,730.0,294.0,0.9004629254341125
81,tacticam,17,31,595,253,626,296,31,43,610.5,274.5,0.899070680141449
81,tacticam,1,9,427,422,455,470,28,48,441.0,446.0,0.8988374471664429
81,tacticam,9,21,465,353,497,397,32,44,481.0,375.0,0.8980861902236938
81,tacticam,21,16,918,222,952,265,34,43,935.0,243.5,0.8980178236961365
81,tacticam,11,14,407,362,432,415,25,53,419.5,388.5,0.8948256969451904
81,tacticam,24,34,41,333,63,387,22,54,52.0,360.0,0.8570420742034912
82,broadcast,2,2,1385,688,1449,810,64,122,1417.0,749.0,0.9169093370437622
82,broadcast,19,19,1544,572,1598,676,54,104,1571.0,624.0,0.9130006432533264
82,broadcast,22,22,1426,508,1484,591,58,83,1455.0,549.5,0.906795084476471
82,broadcast,3,3,754,624,801,724,47,100,777.5,674.0,0.9027491807937622
82,broadcast,14,14,1249,537,1297,642,48,105,1273.0,589.5,0.9015419483184814
82,broadcast,9,9,920,604,976,703,56,99,948.0,653.5,0.8993136286735535
82,broadcast,5,5,1313,537,1346,639,33,102,1329.5,588.0,0.8786449432373047
82,broadcast,17,17,1616,502,1666,597,50,95,1641.0,549.5,0.8735053539276123
82,broadcast,20,20,1521,509,1548,595,27,86,1534.5,552.0,0.8626933693885803
82,broadcast,21,21,1464,477,1494,554,30,77,1479.0,515.5,0.8595919013023376
82,tacticam,7,29,1652,491,1690,544,38,53,1671.0,517.5,0.9330280423164368
82,tacticam,13,10,869,366,898,413,29,47,883.5,389.5,0.9174252152442932
82,tacticam,2,15,1748,385,1780,440,32,55,1764.0,412.5,0.9171093702316284
82,tacticam,17,31,594,253,624,296,30,43,609.0,274.5,0.9148295521736145
82,tacticam,10,3,362,544,387,601,25,57,374.5,572.5,0.9121378660202026
82,tacticam,8,8,1392,730,1420,796,28,66,1406.0,763.0,0.9057607650756836
82,tacticam,6,22,1263,394,1286,442,23,48,1274.5,418.0,0.9050700068473816
82,tacticam,21,16,918,223,952,265,34,42,935.0,244.0,0.901477038860321
82,tacticam,3,12,1055,467,1083,516,28,49,1069.0,491.5,0.8946524858474731
82,tacticam,18,7,1546,304,1576,348,30,44,1561.0,326.0,0.894339382648468
82,tacticam,19,27,695,204,718,248,23,44,706.5,226.0,0.8891189694404602
82,tacticam,1,9,424,420,449,471,25,51,436.5,445.5,0.8877980709075928
82,tacticam,11,14,409,361,431,414,22,53,420.0,387.5,0.883895754814148
82,tacticam,5,2,748,503,787,554,39,51,767.5,528.5,0.8832957744598389
82,tacticam,4,20,970,268,993,312,23,44,981.5,290.0,0.8629364967346191
82,tacticam,24,34,45,333,69,387,24,54,57.0,360.0,0.7356337904930115
83,broadcast,2,2,1396,691,1456,810,60,119,1426.0,750.5,0.91817706823349
83,broadcast,19,19,1538,571,1613,675,75,104,1575.5,623.0,0.9137992858886719
83,broadcast,14,14,1264,536,1306,641,42,105,1285.0,588.5,0.9122089743614197
83,broadcast,3,3,761,624,808,722,47,98,784.5,673.0,0.9000451564788818
83,broadcast,9,9,929,603,987,703,58,100,958.0,653.0,0.8952405452728271
83,broadcast,22,22,1437,504,1487,590,50,86,1462.0,547.0,0.8950234055519104
83,broadcast,5,5,1330,540,1364,640,34,100,1347.0,590.0,0.8842656016349792
83,broadcast,20,20,1530,508,1558,590,28,82,1544.0,549.0,0.8769335746765137
83,broadcast,21,21,1470,477,1509,553,39,76,1489.5,515.0,0.8640195727348328
83,broadcast,17,17,1629,502,1683,591,54,89,1656.0,546.5,0.8354153037071228
83,tacticam,4,20,966,268,994,312,28,44,980.0,290.0,0.9258635640144348
83,tacticam,7,29,1652,491,1691,543,39,52,1671.5,517.0,0.9242173433303833
83,tacticam,2,15,1750,387,1783,440,33,53,1766.5,413.5,0.9201004505157471
83,tacticam,13,10,871,364,898,411,27,47,884.5,387.5,0.9194672703742981
83,tacticam,6,22,1263,393,1291,442,28,49,1277.0,417.5,0.9185683727264404
83,tacticam,10,3,360,540,392,599,32,59,376.0,569.5,0.9136120080947876
83,tacticam,5,2,745,502,783,553,38,51,764.0,527.5,0.9105812907218933
83,tacticam,17,31,596,252,626,296,30,44,611.0,274.0,0.909574568271637
83,tacticam,8,8,1394,728,1423,795,29,67,1408.5,761.5,0.9050618410110474
83,tacticam,1,9,425,416,448,468,23,52,436.5,442.0,0.903974711894989
83,tacticam,12,19,754,346,789,391,35,45,771.5,368.5,0.9005611538887024
83,tacticam,3,12,1054,466,1085,515,31,49,1069.5,490.5,0.8984630703926086
83,tacticam,19,27,694,204,718,248,24,44,706.0,226.0,0.8838368058204651
83,tacticam,18,7,1551,303,1576,349,25,46,1563.5,326.0,0.8753887414932251
84,broadcast,19,19,1547,570,1622,673,75,103,1584.5,621.5,0.9182983636856079
84,broadcast,3,3,767,623,813,721,46,98,790.0,672.0,0.9071367383003235
84,broadcast,17,17,1644,503,1694,596,50,93,1669.0,549.5,0.9045711755752563
84,broadcast,2,2,1409,691,1462,810,53,119,1435.5,750.5,0.8982215523719788
84,broadcast,14,14,1278,535,1315,642,37,107,1296.5,588.5,0.8945587277412415
84,broadcast,22,22,1451,501,1495,591,44,90,1473.0,546.0,0.8821873068809509
84,broadcast,9,9,937,603,991,704,54,101,964.0,653.5,0.8821728229522705
84,broadcast,5,5,1349,540,1381,641,32,101,1365.0,590.5,0.8781894445419312
84,broadcast,20,20,1539,505,1572,595,33,90,1555.5,550.0,0.8775957822799683
84,broadcast,15,15,825,563,888,643,63,80,856.5,603.0,0.8565458059310913
84,broadcast,21,21,1481,477,1521,553,40,76,1501.0,515.0,0.8392795324325562
84,tacticam,4,20,963,268,997,311,34,43,980.0,289.5,0.9236819744110107
84,tacticam,6,22,1262,393,1294,442,32,49,1278.0,417.5,0.9198359847068787
84,tacticam,2,15,1755,388,1785,441,30,53,1770.0,414.5,0.9196200966835022
84,tacticam,7,29,1655,492,1691,544,36,52,1673.0,518.0,0.9184142351150513
84,tacticam,10,3,359,538,391,590,32,52,375.0,564.0,0.9183701872825623
84,tacticam,1,9,424,414,451,467,27,53,437.5,440.5,0.9149340987205505
84,tacticam,8,8,1393,727,1426,794,33,67,1409.5,760.5,0.9139658808708191
84,tacticam,5,2,745,499,778,553,33,54,761.5,526.0,0.9134403467178345
84,tacticam,12,19,756,347,787,393,31,46,771.5,370.0,0.912043035030365
84,tacticam,3,12,1051,465,1085,513,34,48,1068.0,489.0,0.9096583127975464
84,tacticam,13,10,875,363,898,410,23,47,886.5,386.5,0.9016741514205933
84,tacticam,14,5,1232,312,1253,361,21,49,1242.5,336.5,0.898298978805542
84,tacticam,17,31,596,250,629,293,33,43,612.5,271.5,0.8977235555648804
84,tacticam,19,27,691,205,718,247,27,42,704.5,226.0,0.8839208483695984
85,broadcast,2,2,1420,690,1472,811,52,121,1446.0,750.5,0.9113476872444153
85,broadcast,3,3,775,621,817,715,42,94,796.0,668.0,0.90704745054245
85,broadcast,17,17,1658,505,1710,598,52,93,1684.0,551.5,0.9062988758087158
85,broadcast,5,5,1367,542,1401,642,34,100,1384.0,592.0,0.8979660868644714
85,broadcast,19,19,1558,570,1630,677,72,107,1594.0,623.5,0.8961834907531738
85,broadcast,9,9,945,605,992,706,47,101,968.5,655.5,0.8959019780158997
85,broadcast,20,20,1545,508,1586,596,41,88,1565.5,552.0,0.8895813226699829
85,broadcast,14,14,1291,535,1324,642,33,107,1307.5,588.5,0.8885243535041809
85,broadcast,15,15,840,563,907,644,67,81,873.5,603.5,0.8769333958625793
85,broadcast,22,22,1467,504,1511,593,44,89,1489.0,548.5,0.8490760326385498
85,broadcast,21,21,1491,476,1516,542,25,66,1503.5,509.0,0.8406236171722412
85,tacticam,5,2,747,498,779,552,32,54,763.0,525.0,0.9247663021087646
85,tacticam,4,20,964,268,995,311,31,43,979.5,289.5,0.923194408416748
85,tacticam,8,8,1393,726,1429,792,36,66,1411.0,759.0,0.922619640827179
85,tacticam,1,9,422,413,453,463,31,50,437.5,438.0,0.9218440055847168
85,tacticam,3,12,1047,464,1083,510,36,46,1065.0,487.0,0.9188611507415771
85,tacticam,10,3,359,535,389,585,30,50,374.0,560.0,0.917316198348999
85,tacticam,16,4,709,268,739,311,30,43,724.0,289.5,0.9168134927749634
85,tacticam,6,22,1264,393,1297,441,33,48,1280.5,417.0,0.914568305015564
85,tacticam,2,15,1761,388,1785,440,24,52,1773.0,414.0,0.9124090671539307
85,tacticam,17,31,599,249,633,292,34,43,616.0,270.5,0.9121068120002747
85,tacticam,7,29,1661,492,1688,545,27,53,1674.5,518.5,0.9059687852859497
85,tacticam,14,5,1233,313,1258,362,25,49,1245.5,337.5,0.8968693017959595
85,tacticam,11,14,416,350,436,401,20,51,426.0,375.5,0.8904591798782349
85,tacticam,9,21,465,345,490,391,25,46,477.5,368.0,0.8878303170204163
85,tacticam,12,19,755,346,782,390,27,44,768.5,368.0,0.720687747001648
86,broadcast,17,17,1670,508,1727,598,57,90,1698.5,553.0,0.9114110469818115
86,broadcast,20,20,1553,506,1600,597,47,91,1576.5,551.5,0.9105137586593628
86,broadcast,2,2,1430,690,1480,811,50,121,1455.0,750.5,0.9099811911582947
86,broadcast,3,3,782,620,830,714,48,94,806.0,667.0,0.9048659801483154
86,broadcast,19,19,1573,567,1635,679,62,112,1604.0,623.0,0.9018571376800537
86,broadcast,9,9,955,607,999,706,44,99,977.0,656.5,0.8911205530166626
86,broadcast,22,22,1480,499,1527,593,47,94,1503.5,546.0,0.8855190873146057
86,broadcast,5,5,1388,541,1420,642,32,101,1404.0,591.5,0.8847809433937073
86,broadcast,14,14,1305,536,1334,640,29,104,1319.5,588.0,0.8674188256263733
86,broadcast,21,21,1502,478,1527,533,25,55,1514.5,505.5,0.8234074115753174
86,tacticam,5,2,745,495,779,549,34,54,762.0,522.0,0.9310985803604126
86,tacticam,14,5,1235,312,1263,362,28,50,1249.0,337.0,0.9183894991874695
86,tacticam,8,8,1396,727,1430,791,34,64,1413.0,759.0,0.9155228137969971
86,tacticam,3,12,1044,464,1078,512,34,48,1061.0,488.0,0.9133570194244385
86,tacticam,6,22,1268,394,1296,442,28,48,1282.0,418.0,0.9131326079368591
86,tacticam,10,3,357,533,385,585,28,52,371.0,559.0,0.9112337231636047
86,tacticam,11,14,413,349,439,398,26,49,426.0,373.5,0.9008395671844482
86,tacticam,9,21,464,342,490,385,26,43,477.0,363.5,0.896806538105011
86,tacticam,7,29,1663,492,1685,546,22,54,1674.0,519.0,0.8931772112846375
86,tacticam,15,11,941,217,968,257,27,40,954.5,237.0,0.8793022036552429
86,tacticam,20,17,736,207,764,249,28,42,750.0,228.0,0.8718471527099609
86,tacticam,4,20,967,267,993,311,26,44,980.0,289.0,0.8668665885925293
86,tacticam,1,9,421,410,450,459,29,49,435.5,434.5,0.8527260422706604
86,tacticam,24,34,63,332,92,384,29,52,77.5,358.0,0.746121883392334
87,broadcast,2,2,1435,689,1492,812,57,123,1463.5,750.5,0.9195495247840881
87,broadcast,9,9,957,607,1010,707,53,100,983.5,657.0,0.9075499773025513
87,broadcast,20,20,1562,508,1621,598,59,90,1591.5,553.0,0.9049304127693176
87,broadcast,17,17,1684,512,1744,600,60,88,1714.0,556.0,0.8991255760192871
87,broadcast,14,14,1319,535,1351,644,32,109,1335.0,589.5,0.8945055603981018
87,broadcast,5,5,1406,543,1440,643,34,100,1423.0,593.0,0.8897782564163208
87,broadcast,3,3,797,619,844,715,47,96,820.5,667.0,0.8838272094726562
87,broadcast,22,22,1491,508,1545,593,54,85,1518.0,550.5,0.8739466071128845
87,broadcast,21,21,1512,481,1539,540,27,59,1525.5,510.5,0.8608181476593018
87,broadcast,19,19,1593,570,1639,680,46,110,1616.0,625.0,0.8511655926704407
87,tacticam,5,2,744,495,778,545,34,50,761.0,520.0,0.9318822026252747
87,tacticam,8,8,1399,727,1430,789,31,62,1414.5,758.0,0.914306640625
87,tacticam,10,3,358,531,382,585,24,54,370.0,558.0,0.9138432145118713
87,tacticam,14,5,1241,312,1267,362,26,50,1254.0,337.0,0.9122355580329895
87,tacticam,21,16,914,223,942,264,28,41,928.0,243.5,0.9067874550819397
87,tacticam,6,22,1271,395,1296,442,25,47,1283.5,418.5,0.9055247902870178
87,tacticam,9,21,462,339,493,384,31,45,477.5,361.5,0.9018727540969849
87,tacticam,12,19,754,342,778,391,24,49,766.0,366.5,0.9002642035484314
87,tacticam,1,9,420,410,453,457,33,47,436.5,433.5,0.89863121509552
87,tacticam,19,27,685,208,715,250,30,42,700.0,229.0,0.8984711170196533
87,tacticam,7,29,1663,492,1684,546,21,54,1673.5,519.0,0.8981744647026062
87,tacticam,11,14,415,348,439,397,24,49,427.0,372.5,0.8935582041740417
87,tacticam,3,12,1046,463,1072,512,26,49,1059.0,487.5,0.8904164433479309
87,tacticam,13,10,880,359,900,410,20,51,890.0,384.5,0.8790223598480225
88,broadcast,2,2,1439,689,1505,812,66,123,1472.0,750.5,0.9315034747123718
88,broadcast,14,14,1328,541,1370,644,42,103,1349.0,592.5,0.9169318675994873
88,broadcast,17,17,1699,514,1757,601,58,87,1728.0,557.5,0.9139797687530518
88,broadcast,9,9,965,608,1019,708,54,100,992.0,658.0,0.9123460650444031
88,broadcast,3,3,806,624,859,713,53,89,832.5,668.5,0.8973819613456726
88,broadcast,5,5,1427,544,1461,644,34,100,1444.0,594.0,0.8914850950241089
88,broadcast,22,22,1502,521,1562,594,60,73,1532.0,557.5,0.8629342317581177
88,broadcast,19,19,1603,577,1640,680,37,103,1621.5,628.5,0.8439996838569641
88,broadcast,20,20,1578,510,1632,599,54,89,1605.0,554.5,0.822971522808075
88,broadcast,21,21,1518,481,1558,546,40,65,1538.0,513.5,0.8094326853752136
88,tacticam,5,2,739,495,778,544,39,49,758.5,519.5,0.9278246164321899
88,tacticam,14,5,1243,312,1272,362,29,50,1257.5,337.0,0.9175739884376526
88,tacticam,16,4,701,263,735,308,34,45,718.0,285.5,0.9172107577323914
88,tacticam,10,3,358,527,384,584,26,57,371.0,555.5,0.9115854501724243
88,tacticam,9,21,457,337,492,379,35,42,474.5,358.0,0.910538375377655
88,tacticam,8,8,1402,727,1426,789,24,62,1414.0,758.0,0.9095805287361145
88,tacticam,7,29,1662,491,1687,546,25,55,1674.5,518.5,0.9076335430145264
88,tacticam,21,16,911,223,940,264,29,41,925.5,243.5,0.905117392539978
88,tacticam,18,7,1559,302,1585,348,26,46,1572.0,325.0,0.9040740132331848
88,tacticam,12,19,753,342,781,391,28,49,767.0,366.5,0.8984964489936829
88,tacticam,11,14,415,345,441,395,26,50,428.0,370.0,0.898053765296936
88,tacticam,19,27,684,208,716,250,32,42,700.0,229.0,0.8951135873794556
88,tacticam,13,10,881,356,903,407,22,51,892.0,381.5,0.8838202953338623
88,tacticam,1,9,418,410,448,459,30,49,433.0,434.5,0.7830346822738647
89,broadcast,2,2,1448,690,1518,811,70,121,1483.0,750.5,0.9321773648262024
89,broadcast,14,14,1336,544,1388,646,52,102,1362.0,595.0,0.9194728136062622
89,broadcast,17,17,1714,516,1768,605,54,89,1741.0,560.5,0.912242591381073
89,broadcast,9,9,979,608,1030,707,51,99,1004.5,657.5,0.9044594168663025
89,broadcast,3,3,813,624,864,710,51,86,838.5,667.0,0.8984135985374451
89,broadcast,5,5,1446,544,1480,644,34,100,1463.0,594.0,0.8899109959602356
89,broadcast,22,22,1514,487,1578,597,64,110,1546.0,542.0,0.8773313164710999
89,broadcast,19,19,1611,580,1652,681,41,101,1631.5,630.5,0.8750088810920715
89,broadcast,20,20,1595,513,1642,602,47,89,1618.5,557.5,0.8559257388114929
89,tacticam,7,29,1662,490,1690,546,28,56,1676.0,518.0,0.9281456470489502
89,tacticam,8,8,1403,726,1425,789,22,63,1414.0,757.5,0.9245821237564087
89,tacticam,9,21,456,336,490,377,34,41,473.0,356.5,0.9200035333633423
89,tacticam,5,2,737,494,771,543,34,49,754.0,518.5,0.9184974431991577
89,tacticam,18,7,1559,302,1589,348,30,46,1574.0,325.0,0.9152582287788391
89,tacticam,10,3,357,522,385,579,28,57,371.0,550.5,0.9132006168365479
89,tacticam,16,4,704,262,729,308,25,46,716.5,285.0,0.9122933149337769
89,tacticam,12,19,752,341,783,388,31,47,767.5,364.5,0.9108422994613647
89,tacticam,14,5,1249,312,1276,362,27,50,1262.5,337.0,0.9085783958435059
89,tacticam,2,15,1773,389,1794,441,21,52,1783.5,415.0,0.9035729765892029
89,tacticam,19,27,684,208,717,250,33,42,700.5,229.0,0.8991473913192749
89,tacticam,13,10,881,354,906,406,25,52,893.5,380.0,0.8983944058418274
89,tacticam,3,12,1038,461,1064,512,26,51,1051.0,486.5,0.8914240598678589
89,tacticam,15,11,935,217,964,258,29,41,949.5,237.5,0.8858035206794739
89,tacticam,11,14,418,343,442,393,24,50,430.0,368.0,0.8660449981689453
90,broadcast,2,2,1462,693,1529,813,67,120,1495.5,753.0,0.927899956703186
90,broadcast,17,17,1727,516,1784,608,57,92,1755.5,562.0,0.9234158396720886
90,broadcast,9,9,993,608,1039,704,46,96,1016.0,656.0,0.921497642993927
90,broadcast,14,14,1346,548,1406,648,60,100,1376.0,598.0,0.9168624877929688
90,broadcast,19,19,1619,577,1671,686,52,109,1645.0,631.5,0.8922163248062134
90,broadcast,5,5,1465,546,1500,646,35,100,1482.5,596.0,0.8860490918159485
90,broadcast,22,22,1526,500,1590,598,64,98,1558.0,549.0,0.873824417591095
90,broadcast,20,20,1614,515,1653,599,39,84,1633.5,557.0,0.8590524792671204
90,broadcast,15,15,910,563,977,649,67,86,943.5,606.0,0.8316316604614258
90,broadcast,3,3,820,627,868,708,48,81,844.0,667.5,0.8150070905685425
90,broadcast,21,21,1529,480,1574,554,45,74,1551.5,517.0,0.675789475440979
90,broadcast,24,24,834,629,874,712,40,83,854.0,670.5,0.8368529677391052
90,tacticam,8,8,1405,723,1426,788,21,65,1415.5,755.5,0.9286292791366577
90,tacticam,7,29,1661,489,1694,544,33,55,1677.5,516.5,0.922743022441864
90,tacticam,10,3,357,518,388,572,31,54,372.5,545.0,0.9191659092903137
90,tacticam,5,2,738,495,768,542,30,47,753.0,518.5,0.9182324409484863
90,tacticam,2,15,1771,388,1798,441,27,53,1784.5,414.5,0.9175697565078735
90,tacticam,18,7,1561,301,1592,348,31,47,1576.5,324.5,0.91664057970047
90,tacticam,14,5,1254,311,1279,360,25,49,1266.5,335.5,0.912932813167572
90,tacticam,3,12,1035,460,1065,510,30,50,1050.0,485.0,0.910787045955658
90,tacticam,12,19,749,340,784,386,35,46,766.5,363.0,0.9076728224754333
90,tacticam,19,27,683,208,717,249,34,41,700.0,228.5,0.9037621021270752
90,tacticam,9,21,460,332,487,377,27,45,473.5,354.5,0.8997182846069336
90,tacticam,21,16,913,223,940,264,27,41,926.5,243.5,0.8861157298088074
90,tacticam,13,10,883,353,907,400,24,47,895.0,376.5,0.7941628694534302
91,broadcast,2,2,1479,695,1536,814,57,119,1507.5,754.5,0.9184665679931641
91,broadcast,14,14,1363,549,1423,650,60,101,1393.0,599.5,0.9175731539726257
91,broadcast,17,17,1744,516,1801,610,57,94,1772.5,563.0,0.9123516082763672
91,broadcast,19,19,1625,576,1684,686,59,110,1654.5,631.0,0.9046226143836975
91,broadcast,5,5,1483,550,1520,649,37,99,1501.5,599.5,0.9007505774497986
91,broadcast,9,9,1008,608,1047,704,39,96,1027.5,656.0,0.8984651565551758
91,broadcast,24,24,839,631,888,713,49,82,863.5,672.0,0.8678120374679565
91,broadcast,20,20,1627,515,1663,595,36,80,1645.0,555.0,0.8670194149017334
91,broadcast,22,22,1547,511,1602,599,55,88,1574.5,555.0,0.8507452607154846
91,broadcast,15,15,922,568,981,651,59,83,951.5,609.5,0.8488354682922363
91,broadcast,21,21,1538,480,1579,561,41,81,1558.5,520.5,0.8350568413734436
91,broadcast,3,3,825,631,877,712,52,81,851.0,671.5,0.6109151840209961
91,tacticam,7,29,1656,488,1697,544,41,56,1676.5,516.0,0.9236494302749634
91,tacticam,2,15,1773,388,1804,442,31,54,1788.5,415.0,0.9213178157806396
91,tacticam,10,3,356,516,388,567,32,51,372.0,541.5,0.9204593300819397
91,tacticam,3,12,1033,458,1065,507,32,49,1049.0,482.5,0.9182001948356628
91,tacticam,8,8,1406,722,1432,788,26,66,1419.0,755.0,0.9157729744911194
91,tacticam,18,7,1564,303,1594,349,30,46,1579.0,326.0,0.9136040210723877
91,tacticam,12,19,747,339,781,386,34,47,764.0,362.5,0.9080584049224854
91,tacticam,6,22,1278,392,1300,440,22,48,1289.0,416.0,0.8996133804321289
91,tacticam,5,2,738,493,760,543,22,50,749.0,518.0,0.8990972638130188
91,tacticam,17,31,596,249,631,291,35,42,613.5,270.0,0.8988649845123291
91,tacticam,14,5,1259,311,1281,361,22,50,1270.0,336.0,0.8940145969390869
91,tacticam,19,27,683,209,717,251,34,42,700.0,230.0,0.8878332376480103
91,tacticam,9,21,456,331,485,375,29,44,470.5,353.0,0.8819801807403564
91,tacticam,11,14,418,340,445,389,27,49,431.5,364.5,0.8011243343353271
92,broadcast,2,2,1496,697,1543,816,47,119,1519.5,756.5,0.922999382019043
92,broadcast,14,14,1379,549,1433,653,54,104,1406.0,601.0,0.9141787886619568
92,broadcast,17,17,1759,515,1813,611,54,96,1786.0,563.0,0.9132679104804993
92,broadcast,9,9,1021,605,1055,705,34,100,1038.0,655.0,0.9128058552742004
92,broadcast,19,19,1621,579,1695,685,74,106,1658.0,632.0,0.9056731462478638
92,broadcast,5,5,1502,551,1538,651,36,100,1520.0,601.0,0.888469398021698
92,broadcast,21,21,1545,480,1582,562,37,82,1563.5,521.0,0.8844799995422363
92,broadcast,20,20,1642,515,1677,588,35,73,1659.5,551.5,0.8769417405128479
92,broadcast,24,24,834,632,902,716,68,84,868.0,674.0,0.8442429900169373
92,broadcast,22,22,1563,504,1607,600,44,96,1585.0,552.0,0.8264671564102173
92,broadcast,15,15,930,571,985,653,55,82,957.5,612.0,0.8205453157424927
92,tacticam,2,15,1778,388,1809,443,31,55,1793.5,415.5,0.9258356690406799
92,tacticam,8,8,1405,721,1436,786,31,65,1420.5,753.5,0.9219288229942322
92,tacticam,7,29,1656,489,1699,543,43,54,1677.5,516.0,0.9217193126678467
92,tacticam,3,12,1027,458,1063,508,36,50,1045.0,483.0,0.9166919589042664
92,tacticam,11,14,421,338,448,386,27,48,434.5,362.0,0.9149783253669739
92,tacticam,5,2,737,491,763,543,26,52,750.0,517.0,0.9102575778961182
92,tacticam,6,22,1279,393,1304,441,25,48,1291.5,417.0,0.9080182909965515
92,tacticam,10,3,357,514,385,564,28,50,371.0,539.0,0.9055979251861572
92,tacticam,12,19,749,340,776,388,27,48,762.5,364.0,0.9010607600212097
92,tacticam,9,21,462,327,488,374,26,47,475.0,350.5,0.8959130644798279
92,tacticam,16,4,703,259,727,305,24,46,715.0,282.0,0.881242036819458
92,tacticam,19,27,684,209,716,252,32,43,700.0,230.5,0.8612762689590454
92,tacticam,4,20,969,269,999,311,30,42,984.0,290.0,0.8594290018081665
92,tacticam,18,7,1570,305,1594,350,24,45,1582.0,327.5,0.8560526371002197
92,tacticam,17,31,596,249,628,290,32,41,612.0,269.5,0.8398263454437256
93,broadcast,17,17,1773,515,1822,614,49,99,1797.5,564.5,0.9185276627540588
93,broadcast,2,2,1506,698,1552,818,46,120,1529.0,758.0,0.9152941703796387
93,broadcast,19,19,1629,582,1705,684,76,102,1667.0,633.0,0.9052823781967163
93,broadcast,21,21,1551,484,1589,564,38,80,1570.0,524.0,0.8858779072761536
93,broadcast,5,5,1518,551,1556,653,38,102,1537.0,602.0,0.8840155005455017
93,broadcast,20,20,1655,515,1689,590,34,75,1672.0,552.5,0.8762372136116028
93,broadcast,3,3,824,635,889,715,65,80,856.5,675.0,0.8430739045143127
93,broadcast,15,15,940,575,991,657,51,82,965.5,616.0,0.8380594253540039
93,broadcast,22,22,1578,507,1613,602,35,95,1595.5,554.5,0.6454970836639404
93,broadcast,25,25,1031,604,1063,708,32,104,1047.0,656.0,0.9089507460594177
93,broadcast,26,26,1394,549,1444,652,50,103,1419.0,600.5,0.9003748893737793
93,broadcast,27,27,1579,540,1614,602,35,62,1596.5,571.0,0.7937257289886475
93,tacticam,8,8,1403,720,1440,786,37,66,1421.5,753.0,0.932390034198761
93,tacticam,5,2,733,490,765,542,32,52,749.0,516.0,0.9227674007415771
93,tacticam,11,14,422,337,451,383,29,46,436.5,360.0,0.9225422143936157
93,tacticam,6,22,1281,392,1307,438,26,46,1294.0,415.0,0.9218316674232483
93,tacticam,2,15,1782,389,1812,443,30,54,1797.0,416.0,0.9200889468193054
93,tacticam,7,29,1661,490,1699,544,38,54,1680.0,517.0,0.90875643491745
93,tacticam,1,9,422,402,448,454,26,52,435.0,428.0,0.9054094552993774
93,tacticam,16,4,698,258,727,304,29,46,712.5,281.0,0.904924750328064
93,tacticam,10,3,356,511,383,566,27,55,369.5,538.5,0.9041138887405396
93,tacticam,3,12,1027,457,1057,508,30,51,1042.0,482.5,0.9040889143943787
93,tacticam,9,21,462,325,491,369,29,44,476.5,347.0,0.9016181230545044
93,tacticam,15,11,932,217,960,260,28,43,946.0,238.5,0.8934193253517151
93,tacticam,4,20,967,267,1000,309,33,42,983.5,288.0,0.8900734186172485
93,tacticam,17,31,596,249,628,289,32,40,612.0,269.0,0.8498268127441406
94,broadcast,17,17,1784,514,1827,616,43,102,1805.5,565.0,0.9266460537910461
94,broadcast,2,2,1517,699,1562,821,45,122,1539.5,760.0,0.9088810086250305
94,broadcast,14,14,1408,548,1451,654,43,106,1429.5,601.0,0.9061097502708435
94,broadcast,19,19,1636,592,1711,690,75,98,1673.5,641.0,0.902667760848999
94,broadcast,9,9,1039,604,1070,707,31,103,1054.5,655.5,0.8967779278755188
94,broadcast,5,5,1534,555,1571,656,37,101,1552.5,605.5,0.8954399824142456
94,broadcast,20,20,1665,515,1703,606,38,91,1684.0,560.5,0.8615038990974426
94,broadcast,22,22,1584,500,1620,603,36,103,1602.0,551.5,0.8611671924591064
94,broadcast,21,21,1556,486,1598,565,42,79,1577.0,525.5,0.8474287986755371
94,broadcast,15,15,945,578,1002,659,57,81,973.5,618.5,0.8346632719039917
94,tacticam,8,8,1404,720,1443,784,39,64,1423.5,752.0,0.9321805834770203
94,tacticam,5,2,731,488,766,539,35,51,748.5,513.5,0.9268935322761536
94,tacticam,1,9,420,400,450,453,30,53,435.0,426.5,0.9175027012825012
94,tacticam,2,15,1787,390,1816,443,29,53,1801.5,416.5,0.9122715592384338
94,tacticam,16,4,695,258,727,302,32,44,711.0,280.0,0.9120122194290161
94,tacticam,11,14,424,336,453,379,29,43,438.5,357.5,0.9114534258842468
94,tacticam,10,3,356,509,382,565,26,56,369.0,537.0,0.9080773591995239
94,tacticam,6,22,1283,392,1310,437,27,45,1296.5,414.5,0.906032383441925
94,tacticam,9,21,460,324,491,365,31,41,475.5,344.5,0.9038456678390503
94,tacticam,7,29,1666,490,1698,544,32,54,1682.0,517.0,0.900444746017456
94,tacticam,15,11,933,214,960,257,27,43,946.5,235.5,0.896812915802002
94,tacticam,3,12,1028,458,1050,509,22,51,1039.0,483.5,0.8946887254714966
94,tacticam,4,20,970,268,1000,311,30,43,985.0,289.5,0.8763248920440674
95,broadcast,17,17,1795,514,1835,617,40,103,1815.0,565.5,0.9233179092407227
95,broadcast,19,19,1644,595,1713,695,69,100,1678.5,645.0,0.9152652025222778
95,broadcast,2,2,1525,700,1572,824,47,124,1548.5,762.0,0.9140740036964417
95,broadcast,9,9,1045,604,1078,705,33,101,1061.5,654.5,0.8998046517372131
95,broadcast,20,20,1674,516,1712,615,38,99,1693.0,565.5,0.8964018225669861
95,broadcast,14,14,1419,548,1454,655,35,107,1436.5,601.5,0.8879005312919617
95,broadcast,5,5,1550,559,1585,658,35,99,1567.5,608.5,0.878049373626709
95,broadcast,22,22,1595,501,1627,604,32,103,1611.0,552.5,0.8706092834472656
95,broadcast,21,21,1566,492,1603,565,37,73,1584.5,528.5,0.8111767172813416
95,tacticam,8,8,1406,720,1445,783,39,63,1425.5,751.5,0.9247338175773621
95,tacticam,2,15,1792,391,1816,443,24,52,1804.0,417.0,0.9097104072570801
95,tacticam,16,4,694,258,723,302,29,44,708.5,280.0,0.9089657664299011
95,tacticam,10,3,356,506,382,563,26,57,369.0,534.5,0.9070155024528503
95,tacticam,9,21,458,321,489,361,31,40,473.5,341.0,0.9055641293525696
95,tacticam,12,19,747,339,771,387,24,48,759.0,363.0,0.9038770198822021
95,tacticam,1,9,417,399,452,449,35,50,434.5,424.0,0.9035574197769165
95,tacticam,11,14,426,337,454,378,28,41,440.0,357.5,0.9032896757125854
95,tacticam,21,16,912,222,940,263,28,41,926.0,242.5,0.9000449776649475
95,tacticam,15,11,931,215,959,258,28,43,945.0,236.5,0.8858498334884644
95,tacticam,4,20,973,270,999,312,26,42,986.0,291.0,0.8665881752967834
95,tacticam,7,29,1670,490,1693,543,23,53,1681.5,516.5,0.8358519077301025
96,broadcast,17,17,1806,514,1846,619,40,105,1826.0,566.5,0.9151198267936707
96,broadcast,2,2,1534,702,1579,825,45,123,1556.5,763.5,0.9130047559738159
96,broadcast,19,19,1658,598,1712,697,54,99,1685.0,647.5,0.9119495153427124
96,broadcast,9,9,1046,606,1084,709,38,103,1065.0,657.5,0.9054528474807739
96,broadcast,14,14,1427,549,1459,657,32,108,1443.0,603.0,0.8962790369987488
96,broadcast,20,20,1678,518,1725,616,47,98,1701.5,567.0,0.8930666446685791
96,broadcast,22,22,1602,502,1636,607,34,105,1619.0,554.5,0.8775330781936646
96,broadcast,5,5,1565,559,1599,662,34,103,1582.0,610.5,0.8589034080505371
96,broadcast,21,21,1579,494,1608,559,29,65,1593.5,526.5,0.8535361886024475
96,broadcast,25,25,971,588,1028,664,57,76,999.5,626.0,0.8455700874328613
96,broadcast,15,15,934,585,987,657,53,72,960.5,621.0,0.6521639823913574
96,tacticam,8,8,1411,721,1445,782,34,61,1428.0,751.5,0.9199579358100891
96,tacticam,12,19,744,338,773,385,29,47,758.5,361.5,0.9156295657157898
96,tacticam,10,3,358,502,383,556,25,54,370.5,529.0,0.9142385125160217
96,tacticam,1,9,415,397,453,446,38,49,434.0,421.5,0.9027335047721863
96,tacticam,11,14,430,336,455,377,25,41,442.5,356.5,0.8956251740455627
96,tacticam,9,21,458,320,487,361,29,41,472.5,340.5,0.894392728805542
96,tacticam,21,16,908,222,937,264,29,42,922.5,243.0,0.8929618000984192
96,tacticam,3,12,1018,455,1045,506,27,51,1031.5,480.5,0.8771997094154358
96,tacticam,13,10,895,344,917,395,22,51,906.0,369.5,0.860258162021637
96,tacticam,15,11,929,214,955,255,26,41,942.0,234.5,0.8317196369171143
96,tacticam,7,29,1669,489,1690,549,21,60,1679.5,519.0,0.7264519333839417
97,broadcast,2,2,1532,704,1588,828,56,124,1560.0,766.0,0.9175050258636475
97,broadcast,17,17,1816,516,1856,621,40,105,1836.0,568.5,0.9061015248298645
97,broadcast,14,14,1434,551,1466,660,32,109,1450.0,605.5,0.903662919998169
97,broadcast,9,9,1054,608,1089,711,35,103,1071.5,659.5,0.8969697952270508
97,broadcast,20,20,1685,522,1735,618,50,96,1710.0,570.0,0.8960203528404236
97,broadcast,22,22,1607,505,1645,609,38,104,1626.0,557.0,0.8938626646995544
97,broadcast,19,19,1672,596,1707,700,35,104,1689.5,648.0,0.881456196308136
97,broadcast,5,5,1581,560,1615,667,34,107,1598.0,613.5,0.877943217754364
97,broadcast,21,21,1580,496,1611,560,31,64,1595.5,528.0,0.8607236742973328
97,tacticam,12,19,742,337,775,384,33,47,758.5,360.5,0.9312803149223328
97,tacticam,8,8,1412,721,1444,781,32,60,1428.0,751.0,0.9207215309143066
97,tacticam,14,5,1277,311,1299,360,22,49,1288.0,335.5,0.9192910194396973
97,tacticam,10,3,356,499,385,550,29,51,370.5,524.5,0.9085533022880554
97,tacticam,1,9,416,397,452,446,36,49,434.0,421.5,0.9053530097007751
97,tacticam,3,12,1015,454,1047,503,32,49,1031.0,478.5,0.9038817286491394
97,tacticam,18,7,1577,301,1601,348,24,47,1589.0,324.5,0.9005548357963562
97,tacticam,9,21,459,317,488,362,29,45,473.5,339.5,0.8922652006149292
97,tacticam,21,16,907,224,935,264,28,40,921.0,244.0,0.8915880918502808
97,tacticam,11,14,433,333,457,377,24,44,445.0,355.0,0.8708606362342834
97,tacticam,17,31,597,246,626,286,29,40,611.5,266.0,0.8681928515434265
97,tacticam,13,10,895,342,920,393,25,51,907.5,367.5,0.7857073545455933
97,tacticam,7,29,1668,489,1692,543,24,54,1680.0,516.0,0.6620646715164185
98,broadcast,20,20,1695,529,1740,619,45,90,1717.5,574.0,0.9185233116149902
98,broadcast,2,2,1535,706,1594,833,59,127,1564.5,769.5,0.9132826328277588
98,broadcast,17,17,1824,518,1862,625,38,107,1843.0,571.5,0.9096167087554932
98,broadcast,14,14,1440,553,1474,664,34,111,1457.0,608.5,0.9035638570785522
98,broadcast,22,22,1615,509,1652,610,37,101,1633.5,559.5,0.898415207862854
98,broadcast,21,21,1583,497,1616,563,33,66,1599.5,530.0,0.8883976936340332
98,broadcast,19,19,1678,598,1708,704,30,106,1693.0,651.0,0.8779998421669006
98,broadcast,9,9,1060,612,1093,714,33,102,1076.5,663.0,0.8716785311698914
98,broadcast,5,5,1593,563,1629,670,36,107,1611.0,616.5,0.8687109351158142
98,tacticam,3,12,1009,452,1043,501,34,49,1026.0,476.5,0.9270192980766296
98,tacticam,7,29,1668,488,1694,544,26,56,1681.0,516.0,0.9242714047431946
98,tacticam,8,8,1411,721,1439,781,28,60,1425.0,751.0,0.9212543964385986
98,tacticam,12,19,737,336,774,383,37,47,755.5,359.5,0.9208599925041199
98,tacticam,14,5,1277,311,1303,360,26,49,1290.0,335.5,0.9200717806816101
98,tacticam,18,7,1576,302,1604,348,28,46,1590.0,325.0,0.9093245267868042
98,tacticam,10,3,355,496,385,547,30,51,370.0,521.5,0.9091563820838928
98,tacticam,5,2,717,486,752,535,35,49,734.5,510.5,0.8981641530990601
98,tacticam,1,9,417,397,451,446,34,49,434.0,421.5,0.8952093124389648
98,tacticam,9,21,459,314,486,360,27,46,472.5,337.0,0.8917368054389954
98,tacticam,16,4,692,257,715,302,23,45,703.5,279.5,0.8856630325317383
98,tacticam,21,16,908,223,932,267,24,44,920.0,245.0,0.87050461769104
99,broadcast,2,2,1541,710,1598,835,57,125,1569.5,772.5,0.9148324131965637
99,broadcast,14,14,1444,557,1481,668,37,111,1462.5,612.5,0.9055174589157104
99,broadcast,20,20,1704,533,1744,622,40,89,1724.0,577.5,0.8989139199256897
99,broadcast,5,5,1607,571,1639,673,32,102,1623.0,622.0,0.8971707224845886
99,broadcast,17,17,1831,523,1872,628,41,105,1851.5,575.5,0.8958585262298584
99,broadcast,22,22,1623,512,1659,613,36,101,1641.0,562.5,0.8926859498023987
99,broadcast,21,21,1584,498,1622,577,38,79,1603.0,537.5,0.888317883014679
99,broadcast,19,19,1679,601,1717,708,38,107,1698.0,654.5,0.8882412314414978
99,broadcast,9,9,1063,617,1099,718,36,101,1081.0,667.5,0.8682623505592346
99,tacticam,7,29,1666,488,1697,543,31,55,1681.5,515.5,0.9244377613067627
99,tacticam,3,12,1005,451,1041,501,36,50,1023.0,476.0,0.9191442728042603
99,tacticam,2,15,1802,390,1825,444,23,54,1813.5,417.0,0.9128276705741882
99,tacticam,8,8,1412,718,1439,781,27,63,1425.5,749.5,0.9125231504440308
99,tacticam,14,5,1280,311,1306,360,26,49,1293.0,335.5,0.9122641086578369
99,tacticam,18,7,1578,302,1607,348,29,46,1592.5,325.0,0.9119386672973633
99,tacticam,10,3,355,494,384,546,29,52,369.5,520.0,0.9025172591209412
99,tacticam,5,2,716,484,747,535,31,51,731.5,509.5,0.8986681699752808
99,tacticam,1,9,413,396,448,445,35,49,430.5,420.5,0.8972742557525635
99,tacticam,9,21,458,313,489,356,31,43,473.5,334.5,0.8931615352630615
99,tacticam,16,4,687,255,717,300,30,45,702.0,277.5,0.8911489844322205
99,tacticam,21,16,911,222,934,266,23,44,922.5,244.0,0.8666659593582153
99,tacticam,19,27,691,214,723,258,32,44,707.0,236.0,0.8422081470489502
99,tacticam,20,17,704,202,731,245,27,43,717.5,223.5,0.7759563326835632
100,broadcast,14,14,1444,559,1488,672,44,113,1466.0,615.5,0.9143764972686768
100,broadcast,17,17,1832,528,1878,631,46,103,1855.0,579.5,0.9092296361923218
100,broadcast,2,2,1551,715,1603,838,52,123,1577.0,776.5,0.9083256125450134
100,broadcast,19,19,1677,601,1728,713,51,112,1702.5,657.0,0.8935238122940063
100,broadcast,21,21,1582,499,1628,584,46,85,1605.0,541.5,0.8928131461143494
100,broadcast,22,22,1628,518,1667,614,39,96,1647.5,566.0,0.8853515982627869
100,broadcast,20,20,1713,537,1746,628,33,91,1729.5,582.5,0.883294403553009
100,broadcast,9,9,1062,619,1103,721,41,102,1082.5,670.0,0.8691337704658508
100,broadcast,5,5,1616,578,1650,676,34,98,1633.0,627.0,0.8490701913833618
100,tacticam,14,5,1283,311,1311,360,28,49,1297.0,335.5,0.9303362965583801
100,tacticam,2,15,1800,390,1828,444,28,54,1814.0,417.0,0.9201081991195679
100,tacticam,7,29,1662,487,1700,542,38,55,1681.0,514.5,0.9154027700424194
100,tacticam,8,8,1413,715,1441,780,28,65,1427.0,747.5,0.9144675135612488
100,tacticam,3,12,1005,451,1035,502,30,51,1020.0,476.5,0.9089475870132446
100,tacticam,5,2,714,482,744,534,30,52,729.0,508.0,0.9066517949104309
100,tacticam,10,3,354,492,382,545,28,53,368.0,518.5,0.9065324664115906
100,tacticam,18,7,1579,304,1609,349,30,45,1594.0,326.5,0.9050317406654358
100,tacticam,12,19,735,338,771,384,36,46,753.0,361.0,0.9038243293762207
100,tacticam,4,20,974,267,1000,311,26,44,987.0,289.0,0.9000091552734375
100,tacticam,1,9,418,394,444,444,26,50,431.0,419.0,0.8891811370849609
100,tacticam,6,22,1289,391,1310,439,21,48,1299.5,415.0,0.8871026635169983
100,tacticam,9,21,459,312,484,355,25,43,471.5,333.5,0.82925945520401
100,tacticam,19,27,689,210,720,259,31,49,704.5,234.5,0.80926913022995
100,tacticam,20,17,701,202,730,251,29,49,715.5,226.5,0.7456501722335815
101,broadcast,14,14,1450,567,1495,674,45,107,1472.5,620.5,0.915537416934967
101,broadcast,2,2,1559,718,1607,841,48,123,1583.0,779.5,0.9072834253311157
101,broadcast,19,19,1673,602,1736,715,63,113,1704.5,658.5,0.9037443995475769
101,broadcast,17,17,1832,533,1882,637,50,104,1857.0,585.0,0.8985127210617065
101,broadcast,21,21,1582,501,1622,588,40,87,1602.0,544.5,0.8910893201828003
101,broadcast,9,9,1059,622,1107,722,48,100,1083.0,672.0,0.8878153562545776
101,broadcast,20,20,1716,537,1749,630,33,93,1732.5,583.5,0.8829461336135864
101,broadcast,5,5,1622,577,1672,680,50,103,1647.0,628.5,0.8730390667915344
101,broadcast,22,22,1637,524,1673,603,36,79,1655.0,563.5,0.8393789529800415
101,tacticam,14,5,1287,311,1314,359,27,48,1300.5,335.0,0.9270467758178711
101,tacticam,2,15,1800,389,1831,444,31,55,1815.5,416.5,0.9248905181884766
101,tacticam,8,8,1413,713,1443,780,30,67,1428.0,746.5,0.9183533787727356
101,tacticam,5,2,714,479,741,533,27,54,727.5,506.0,0.9163216948509216
101,tacticam,7,29,1661,487,1700,542,39,55,1680.5,514.5,0.915789008140564
101,tacticam,17,31,601,244,630,285,29,41,615.5,264.5,0.9152714014053345
101,tacticam,10,3,354,488,378,543,24,55,366.0,515.5,0.9133193492889404
101,tacticam,6,22,1287,391,1315,439,28,48,1301.0,415.0,0.9083361625671387
101,tacticam,1,9,417,392,440,443,23,51,428.5,417.5,0.9000605940818787
101,tacticam,18,7,1583,305,1609,349,26,44,1596.0,327.0,0.8998933434486389
101,tacticam,4,20,970,266,999,308,29,42,984.5,287.0,0.8847647905349731
101,tacticam,3,12,1005,451,1027,502,22,51,1016.0,476.5,0.8795539140701294
101,tacticam,16,4,682,252,717,294,35,42,699.5,273.0,0.8732814788818359
101,tacticam,19,27,687,213,720,257,33,44,703.5,235.0,0.818006694316864
101,tacticam,21,16,922,216,947,257,25,41,934.5,236.5,0.772238552570343
102,broadcast,19,19,1672,604,1742,716,70,112,1707.0,660.0,0.9186197519302368
102,broadcast,9,9,1063,626,1111,726,48,100,1087.0,676.0,0.9160998463630676
102,broadcast,14,14,1457,570,1503,677,46,107,1480.0,623.5,0.9147679805755615
102,broadcast,2,2,1562,719,1611,843,49,124,1586.5,781.0,0.9046281576156616
102,broadcast,17,17,1833,539,1886,640,53,101,1859.5,589.5,0.9040976762771606
102,broadcast,20,20,1723,540,1754,638,31,98,1738.5,589.0,0.8840593695640564
102,broadcast,5,5,1635,581,1683,683,48,102,1659.0,632.0,0.8701990246772766
102,broadcast,21,21,1590,505,1622,591,32,86,1606.0,548.0,0.8652485609054565
102,broadcast,22,22,1645,527,1679,604,34,77,1662.0,565.5,0.8590034246444702
102,tacticam,2,15,1802,391,1834,444,32,53,1818.0,417.5,0.9301009178161621
102,tacticam,14,5,1290,311,1317,360,27,49,1303.5,335.5,0.9251715540885925
102,tacticam,17,31,599,244,632,284,33,40,615.5,264.0,0.9234485030174255
102,tacticam,8,8,1412,711,1445,779,33,68,1428.5,745.0,0.9212955832481384
102,tacticam,5,2,711,479,742,532,31,53,726.5,505.5,0.9199275970458984
102,tacticam,6,22,1286,391,1315,438,29,47,1300.5,414.5,0.9170875549316406
102,tacticam,21,16,911,216,944,264,33,48,927.5,240.0,0.9148015975952148
102,tacticam,7,29,1661,489,1699,543,38,54,1680.0,516.0,0.9122387170791626
102,tacticam,10,3,354,485,378,542,24,57,366.0,513.5,0.9117413759231567
102,tacticam,19,27,686,202,717,253,31,51,701.5,227.5,0.8969603180885315
102,tacticam,1,9,418,390,442,442,24,52,430.0,416.0,0.8874587416648865
102,tacticam,4,20,969,268,1001,308,32,40,985.0,288.0,0.878250777721405
102,tacticam,16,4,682,250,712,295,30,45,697.0,272.5,0.8741925358772278
102,tacticam,3,12,999,450,1021,501,22,51,1010.0,475.5,0.8524819016456604
103,broadcast,17,17,1833,545,1893,643,60,98,1863.0,594.0,0.9194755554199219
103,broadcast,9,9,1070,630,1114,727,44,97,1092.0,678.5,0.9111620783805847
103,broadcast,14,14,1464,575,1510,680,46,105,1487.0,627.5,0.907576322555542
103,broadcast,2,2,1568,718,1615,845,47,127,1591.5,781.5,0.9026956558227539
103,broadcast,19,19,1673,612,1747,717,74,105,1710.0,664.5,0.8954519033432007
103,broadcast,22,22,1647,530,1684,614,37,84,1665.5,572.0,0.892344057559967
103,broadcast,20,20,1728,539,1759,639,31,100,1743.5,589.0,0.8854273557662964
103,broadcast,21,21,1594,510,1622,597,28,87,1608.0,553.5,0.8415963053703308
103,broadcast,5,5,1646,584,1688,685,42,101,1667.0,634.5,0.7656461000442505
103,broadcast,28,28,712,653,736,701,24,48,724.0,677.0,0.7479299902915955
103,tacticam,5,2,709,479,742,530,33,51,725.5,504.5,0.9219465255737305
103,tacticam,14,5,1293,313,1319,360,26,47,1306.0,336.5,0.9210730195045471
103,tacticam,8,8,1411,712,1447,779,36,67,1429.0,745.5,0.9209312200546265
103,tacticam,10,3,354,484,380,539,26,55,367.0,511.5,0.9191021919250488
103,tacticam,2,15,1805,393,1839,446,34,53,1822.0,419.5,0.9175054430961609
103,tacticam,6,22,1284,391,1319,441,35,50,1301.5,416.0,0.9097610116004944
103,tacticam,7,29,1666,490,1697,543,31,53,1681.5,516.5,0.8938379287719727
103,tacticam,21,16,909,215,932,267,23,52,920.5,241.0,0.8905965089797974
103,tacticam,3,12,995,450,1023,500,28,50,1009.0,475.0,0.8898144364356995
103,tacticam,19,27,684,202,714,253,30,51,699.0,227.5,0.8839168548583984
103,tacticam,12,19,729,337,754,383,25,46,741.5,360.0,0.8818411231040955
103,tacticam,1,9,418,391,445,442,27,51,431.5,416.5,0.8519578576087952
103,tacticam,4,20,971,269,998,311,27,42,984.5,290.0,0.8499358296394348
104,broadcast,17,17,1834,548,1902,646,68,98,1868.0,597.0,0.929277241230011
104,broadcast,21,21,1596,512,1627,598,31,86,1611.5,555.0,0.9261062145233154
104,broadcast,14,14,1473,577,1514,682,41,105,1493.5,629.5,0.9109315276145935
104,broadcast,19,19,1676,611,1751,720,75,109,1713.5,665.5,0.9078084230422974
104,broadcast,9,9,1077,629,1118,730,41,101,1097.5,679.5,0.9002404808998108
104,broadcast,20,20,1732,539,1769,639,37,100,1750.5,589.0,0.8977896571159363
104,broadcast,2,2,1572,718,1619,846,47,128,1595.5,782.0,0.8976338505744934
104,broadcast,22,22,1650,530,1687,615,37,85,1668.5,572.5,0.8815060257911682
104,broadcast,5,5,1651,585,1691,686,40,101,1671.0,635.5,0.802790105342865
104,tacticam,5,2,703,476,741,526,38,50,722.0,501.0,0.9183042049407959
104,tacticam,8,8,1411,710,1446,776,35,66,1428.5,743.0,0.9176173210144043
104,tacticam,2,15,1808,391,1841,446,33,55,1824.5,418.5,0.9167515635490417
104,tacticam,3,12,992,447,1021,496,29,49,1006.5,471.5,0.9154979586601257
104,tacticam,10,3,353,478,379,531,26,53,366.0,504.5,0.9132100939750671
104,tacticam,14,5,1296,310,1319,360,23,50,1307.5,335.0,0.9130816459655762
104,tacticam,1,9,415,388,445,438,30,50,430.0,413.0,0.9127703905105591
104,tacticam,6,22,1286,392,1319,440,33,48,1302.5,416.0,0.908176839351654
104,tacticam,21,16,905,215,930,266,25,51,917.5,240.5,0.8950771689414978
104,tacticam,12,19,729,334,756,379,27,45,742.5,356.5,0.8651973009109497
104,tacticam,11,14,455,314,480,362,25,48,467.5,338.0,0.8444773554801941
104,tacticam,19,27,688,199,710,254,22,55,699.0,226.5,0.8017204403877258
104,tacticam,7,29,1668,490,1693,543,25,53,1680.5,516.5,0.7065377831459045
104,tacticam,13,10,904,335,925,384,21,49,914.5,359.5,0.6029999852180481
105,broadcast,17,17,1839,550,1911,648,72,98,1875.0,599.0,0.9187539219856262
105,broadcast,21,21,1594,514,1628,600,34,86,1611.0,557.0,0.9185431599617004
105,broadcast,2,2,1575,718,1623,846,48,128,1599.0,782.0,0.9058054089546204
105,broadcast,20,20,1732,539,1779,643,47,104,1755.5,591.0,0.9028406143188477
105,broadcast,14,14,1476,578,1514,684,38,106,1495.0,631.0,0.8984652757644653
105,broadcast,19,19,1681,626,1750,726,69,100,1715.5,676.0,0.8983601927757263
105,broadcast,22,22,1658,531,1691,624,33,93,1674.5,577.5,0.8792558312416077
105,broadcast,9,9,1081,631,1119,730,38,99,1100.0,680.5,0.874439001083374
105,broadcast,5,5,1661,587,1705,687,44,100,1683.0,637.0,0.751842200756073
105,tacticam,12,19,725,330,754,374,29,44,739.5,352.0,0.9195600152015686
105,tacticam,1,9,411,385,439,432,28,47,425.0,408.5,0.9185500741004944
105,tacticam,5,2,697,473,735,522,38,49,716.0,497.5,0.9182963967323303
105,tacticam,8,8,1412,707,1442,770,30,63,1427.0,738.5,0.9175035357475281
105,tacticam,3,12,981,443,1015,492,34,49,998.0,467.5,0.9138963222503662
105,tacticam,10,3,349,472,375,523,26,51,362.0,497.5,0.9118782877922058
105,tacticam,2,15,1808,388,1840,442,32,54,1824.0,415.0,0.910018801689148
105,tacticam,6,22,1287,389,1312,435,25,46,1299.5,412.0,0.8993496298789978
105,tacticam,21,16,900,212,929,263,29,51,914.5,237.5,0.8990822434425354
105,tacticam,11,14,454,314,478,357,24,43,466.0,335.5,0.8936097621917725
105,tacticam,7,29,1664,485,1686,539,22,54,1675.0,512.0,0.8931557536125183
105,tacticam,19,27,681,195,706,253,25,58,693.5,224.0,0.8875065445899963
105,tacticam,16,4,674,248,699,290,25,42,686.5,269.0,0.8732054829597473
105,tacticam,25,35,151,320,174,368,23,48,162.5,344.0,0.7081402540206909
106,broadcast,2,2,1570,718,1625,849,55,131,1597.5,783.5,0.9360030293464661
106,broadcast,17,17,1849,551,1914,649,65,98,1881.5,600.0,0.9126961827278137
106,broadcast,21,21,1589,517,1633,602,44,85,1611.0,559.5,0.9073958396911621
106,broadcast,20,20,1734,541,1786,646,52,105,1760.0,593.5,0.9014155268669128
106,broadcast,14,14,1480,579,1516,686,36,107,1498.0,632.5,0.8958308100700378
106,broadcast,9,9,1088,631,1122,732,34,101,1105.0,681.5,0.8827757835388184
106,broadcast,22,22,1664,530,1697,635,33,105,1680.5,582.5,0.8755491375923157
106,broadcast,19,19,1689,645,1746,729,57,84,1717.5,687.0,0.8628178238868713
106,broadcast,3,3,896,678,919,732,23,54,907.5,705.0,0.7704945206642151
106,broadcast,5,5,1681,603,1717,689,36,86,1699.0,646.0,0.7369433045387268
106,tacticam,1,9,411,383,436,431,25,48,423.5,407.0,0.9184823036193848
106,tacticam,8,8,1414,706,1439,769,25,63,1426.5,737.5,0.9174183011054993
106,tacticam,2,15,1810,387,1840,441,30,54,1825.0,414.0,0.9150454998016357
106,tacticam,3,12,974,441,1009,490,35,49,991.5,465.5,0.9134747982025146
106,tacticam,12,19,719,325,752,373,33,48,735.5,349.0,0.9126476049423218
106,tacticam,10,3,347,470,370,523,23,53,358.5,496.5,0.9097580909729004
106,tacticam,5,2,694,471,725,522,31,51,709.5,496.5,0.9067187309265137
106,tacticam,21,16,899,212,928,263,29,51,913.5,237.5,0.8998314738273621
106,tacticam,7,29,1662,482,1685,538,23,56,1673.5,510.0,0.8979678153991699
106,tacticam,19,27,672,193,703,254,31,61,687.5,223.5,0.8889116644859314
106,tacticam,16,4,670,245,700,289,30,44,685.0,267.0,0.8880529999732971
106,tacticam,11,14,455,313,482,355,27,42,468.5,334.0,0.8788427114486694
106,tacticam,9,21,446,296,471,341,25,45,458.5,318.5,0.8340075612068176
106,tacticam,6,22,1288,388,1310,434,22,46,1299.0,411.0,0.8225564360618591
106,tacticam,13,10,901,329,925,375,24,46,913.0,352.0,0.8175330758094788
107,broadcast,2,2,1567,721,1628,850,61,129,1597.5,785.5,0.9349917769432068
107,broadcast,21,21,1572,519,1635,604,63,85,1603.5,561.5,0.9154382348060608
107,broadcast,20,20,1736,544,1793,647,57,103,1764.5,595.5,0.9151412844657898
107,broadcast,17,17,1858,551,1915,650,57,99,1886.5,600.5,0.8961146473884583
107,broadcast,14,14,1483,579,1519,687,36,108,1501.0,633.0,0.8919633030891418
107,broadcast,22,22,1668,530,1702,634,34,104,1685.0,582.0,0.8830559849739075
107,broadcast,19,19,1697,641,1742,731,45,90,1719.5,686.0,0.8595436811447144
107,broadcast,9,9,1091,630,1123,733,32,103,1107.0,681.5,0.8383434414863586
107,broadcast,5,5,1688,588,1720,661,32,73,1704.0,624.5,0.7976402640342712
107,broadcast,3,3,857,691,894,736,37,45,875.5,713.5,0.6896243691444397
107,tacticam,1,9,410,385,435,431,25,46,422.5,408.0,0.919615626335144
107,tacticam,10,3,348,468,368,522,20,54,358.0,495.0,0.9152082800865173
107,tacticam,2,15,1815,389,1840,442,25,53,1827.5,415.5,0.9099682569503784
107,tacticam,8,8,1414,706,1436,769,22,63,1425.0,737.5,0.909264326095581
107,tacticam,18,7,1583,299,1610,345,27,46,1596.5,322.0,0.909186065196991
107,tacticam,7,29,1662,482,1688,539,26,57,1675.0,510.5,0.9061864614486694
107,tacticam,3,12,974,442,1004,493,30,51,989.0,467.5,0.9035294651985168
107,tacticam,5,2,692,472,720,523,28,51,706.0,497.5,0.8970914483070374
107,tacticam,17,31,585,241,619,282,34,41,602.0,261.5,0.8967490196228027
107,tacticam,16,4,670,245,700,288,30,43,685.0,266.5,0.8943227529525757
107,tacticam,11,14,457,314,487,355,30,41,472.0,334.5,0.8925579786300659
107,tacticam,19,27,668,195,699,256,31,61,683.5,225.5,0.8905505537986755
107,tacticam,21,16,902,212,926,263,24,51,914.0,237.5,0.873640775680542
107,tacticam,12,19,717,328,746,372,29,44,731.5,350.0,0.8724940419197083
107,tacticam,9,21,445,299,472,339,27,40,458.5,319.0,0.8508107662200928
107,tacticam,13,10,903,329,925,375,22,46,914.0,352.0,0.8470577001571655
108,broadcast,2,2,1564,725,1629,854,65,129,1596.5,789.5,0.9352371692657471
108,broadcast,20,20,1740,545,1798,650,58,105,1769.0,597.5,0.920531153678894
108,broadcast,21,21,1571,523,1635,607,64,84,1603.0,565.0,0.9106389284133911
108,broadcast,14,14,1488,580,1524,690,36,110,1506.0,635.0,0.896287202835083
108,broadcast,17,17,1869,551,1916,652,47,101,1892.5,601.5,0.8908215165138245
108,broadcast,22,22,1668,531,1707,638,39,107,1687.5,584.5,0.889199435710907
108,broadcast,9,9,1092,630,1128,736,36,106,1110.0,683.0,0.8700665235519409
108,broadcast,19,19,1699,636,1733,732,34,96,1716.0,684.0,0.8545276522636414
108,broadcast,5,5,1697,589,1728,658,31,69,1712.5,623.5,0.8382167220115662
108,tacticam,7,29,1658,481,1689,537,31,56,1673.5,509.0,0.9201922416687012
108,tacticam,17,31,583,240,612,282,29,42,597.5,261.0,0.9179493188858032
108,tacticam,8,8,1413,703,1434,767,21,64,1423.5,735.0,0.908385157585144
108,tacticam,18,7,1583,300,1612,345,29,45,1597.5,322.5,0.9047563672065735
108,tacticam,5,2,692,470,716,522,24,52,704.0,496.0,0.9028105735778809
108,tacticam,10,3,346,466,370,519,24,53,358.0,492.5,0.8932257294654846
108,tacticam,11,14,461,314,491,354,30,40,476.0,334.0,0.8931882381439209
108,tacticam,12,19,715,328,743,373,28,45,729.0,350.5,0.8859498500823975
108,tacticam,3,12,974,442,996,492,22,50,985.0,467.0,0.863709568977356
108,tacticam,20,17,667,209,697,261,30,52,682.0,235.0,0.8096495270729065
108,tacticam,21,16,899,209,920,263,21,54,909.5,236.0,0.6957724094390869
108,tacticam,19,27,667,197,695,256,28,59,681.0,226.5,0.6555671095848083
109,broadcast,2,2,1563,728,1631,858,68,130,1597.0,793.0,0.9283632040023804
109,broadcast,20,20,1751,551,1801,652,50,101,1776.0,601.5,0.9120425581932068
109,broadcast,14,14,1492,580,1532,692,40,112,1512.0,636.0,0.9041947722434998
109,broadcast,27,27,1573,527,1626,613,53,86,1599.5,570.0,0.9022578597068787
109,broadcast,22,22,1671,532,1712,638,41,106,1691.5,585.0,0.8962568044662476
109,broadcast,17,17,1879,550,1916,653,37,103,1897.5,601.5,0.8811720609664917
109,broadcast,9,9,1094,631,1130,738,36,107,1112.0,684.5,0.8641505241394043
109,broadcast,19,19,1699,638,1735,735,36,97,1717.0,686.5,0.8559437990188599
109,broadcast,28,28,739,664,766,713,27,49,752.5,688.5,0.6957646608352661
109,broadcast,5,5,1711,589,1732,641,21,52,1721.5,615.0,0.6173388957977295
109,tacticam,17,31,579,241,611,283,32,42,595.0,262.0,0.9263830780982971
109,tacticam,7,29,1652,481,1689,536,37,55,1670.5,508.5,0.9255424737930298
109,tacticam,10,3,344,464,371,518,27,54,357.5,491.0,0.9251483678817749
109,tacticam,1,9,405,384,433,429,28,45,419.0,406.5,0.9133248925209045
109,tacticam,4,20,968,262,992,307,24,45,980.0,284.5,0.9129271507263184
109,tacticam,8,8,1412,702,1433,767,21,65,1422.5,734.5,0.9107329249382019
109,tacticam,5,2,688,469,713,522,25,53,700.5,495.5,0.9062254428863525
109,tacticam,18,7,1583,300,1611,347,28,47,1597.0,323.5,0.8978561162948608
109,tacticam,3,12,968,440,988,491,20,51,978.0,465.5,0.8975970149040222
109,tacticam,11,14,460,314,493,354,33,40,476.5,334.0,0.8937975168228149
109,tacticam,6,22,1286,385,1306,438,20,53,1296.0,411.5,0.8395243883132935
109,tacticam,21,16,894,210,917,262,23,52,905.5,236.0,0.8335282206535339
109,tacticam,20,17,667,213,694,262,27,49,680.5,237.5,0.7519196271896362
110,broadcast,2,2,1562,733,1638,861,76,128,1600.0,797.0,0.9314079880714417
110,broadcast,9,9,1096,629,1133,739,37,110,1114.5,684.0,0.9099982976913452
110,broadcast,22,22,1672,534,1717,640,45,106,1694.5,587.0,0.9099010229110718
110,broadcast,14,14,1494,579,1539,693,45,114,1516.5,636.0,0.9090684056282043
110,broadcast,20,20,1757,562,1801,654,44,92,1779.0,608.0,0.8885050415992737
110,broadcast,27,27,1577,532,1615,614,38,82,1596.0,573.0,0.8876214027404785
110,broadcast,19,19,1697,665,1739,740,42,75,1718.0,702.5,0.8838727474212646
110,broadcast,17,17,1882,548,1919,655,37,107,1900.5,601.5,0.880169689655304
110,broadcast,5,5,1696,634,1739,714,43,80,1717.5,674.0,0.6397696137428284
110,tacticam,5,2,678,469,708,522,30,53,693.0,495.5,0.9249265193939209
110,tacticam,4,20,958,265,988,307,30,42,973.0,286.0,0.9213508367538452
110,tacticam,10,3,337,463,368,516,31,53,352.5,489.5,0.92084139585495
110,tacticam,7,29,1641,482,1684,537,43,55,1662.5,509.5,0.920284628868103
110,tacticam,1,9,396,384,429,430,33,46,412.5,407.0,0.9193919897079468
110,tacticam,11,14,457,315,489,356,32,41,473.0,335.5,0.9179359078407288
110,tacticam,8,8,1405,703,1430,767,25,64,1417.5,735.0,0.9151636958122253
110,tacticam,3,12,957,440,984,491,27,51,970.5,465.5,0.9124917387962341
110,tacticam,18,7,1581,300,1604,348,23,48,1592.5,324.0,0.8954415917396545
110,tacticam,14,5,1298,306,1318,357,20,51,1308.0,331.5,0.8917695879936218
110,tacticam,6,22,1282,388,1303,436,21,48,1292.5,412.0,0.8915431499481201
110,tacticam,21,16,894,220,916,267,22,47,905.0,243.5,0.7855556607246399
110,tacticam,15,11,882,212,906,258,24,46,894.0,235.0,0.7816006541252136
111,broadcast,2,2,1564,736,1644,863,80,127,1604.0,799.5,0.933756947517395
111,broadcast,14,14,1492,579,1544,696,52,117,1518.0,637.5,0.920756459236145
111,broadcast,9,9,1096,630,1136,742,40,112,1116.0,686.0,0.9179616570472717
111,broadcast,27,27,1574,534,1612,617,38,83,1593.0,575.5,0.9151712656021118
111,broadcast,5,5,1688,635,1745,740,57,105,1716.5,687.5,0.9107236266136169
111,broadcast,22,22,1674,536,1723,641,49,105,1698.5,588.5,0.8901815414428711
111,broadcast,17,17,1885,547,1919,656,34,109,1902.0,601.5,0.8791995048522949
111,broadcast,20,20,1764,552,1801,656,37,104,1782.5,604.0,0.8737361431121826
111,broadcast,19,19,1724,598,1748,653,24,55,1736.0,625.5,0.8075982928276062
111,tacticam,11,14,456,311,487,353,31,42,471.5,332.0,0.923574686050415
111,tacticam,4,20,956,263,984,304,28,41,970.0,283.5,0.9212667346000671
111,tacticam,3,12,947,437,979,486,32,49,963.0,461.5,0.9189730286598206
111,tacticam,8,8,1397,698,1430,764,33,66,1413.5,731.0,0.9177895784378052
111,tacticam,10,3,332,458,360,506,28,48,346.0,482.0,0.9152528643608093
111,tacticam,1,9,388,380,426,428,38,48,407.0,404.0,0.915114164352417
111,tacticam,6,22,1274,385,1301,434,27,49,1287.5,409.5,0.9135090112686157
111,tacticam,5,2,672,466,705,518,33,52,688.5,492.0,0.9133381247520447
111,tacticam,7,29,1641,480,1679,535,38,55,1660.0,507.5,0.9131635427474976
111,tacticam,2,15,1809,387,1831,441,22,54,1820.0,414.0,0.8934710025787354
111,tacticam,14,5,1292,306,1317,356,25,50,1304.5,331.0,0.8912193775177002
111,tacticam,25,35,158,313,183,362,25,49,170.5,337.5,0.6191796660423279
112,broadcast,27,27,1569,534,1618,618,49,84,1593.5,576.0,0.9334446787834167
112,broadcast,2,2,1570,740,1652,865,82,125,1611.0,802.5,0.9300122261047363
112,broadcast,9,9,1095,631,1138,743,43,112,1116.5,687.0,0.9149173498153687
112,broadcast,14,14,1494,583,1550,697,56,114,1522.0,640.0,0.9123966097831726
112,broadcast,5,5,1685,635,1751,740,66,105,1718.0,687.5,0.9025850892066956
112,broadcast,22,22,1678,537,1729,646,51,109,1703.5,591.5,0.8979192972183228
112,broadcast,17,17,1886,545,1920,656,34,111,1903.0,600.5,0.876299262046814
112,broadcast,19,19,1773,553,1802,628,29,75,1787.5,590.5,0.8690025210380554
112,broadcast,20,20,1773,589,1802,656,29,67,1787.5,622.5,0.8276470303535461
112,broadcast,29,29,1733,599,1758,683,25,84,1745.5,641.0,0.8245949745178223
112,tacticam,6,22,1273,385,1305,432,32,47,1289.0,408.5,0.9246149659156799
112,tacticam,5,2,668,464,705,514,37,50,686.5,489.0,0.9201790690422058
112,tacticam,8,8,1398,696,1434,760,36,64,1416.0,728.0,0.9199391603469849
112,tacticam,10,3,332,455,359,504,27,49,345.5,479.5,0.9138525724411011
112,tacticam,2,15,1808,385,1835,440,27,55,1821.5,412.5,0.9137282371520996
112,tacticam,11,14,460,307,489,350,29,43,474.5,328.5,0.9061020016670227
112,tacticam,3,12,943,435,977,481,34,46,960.0,458.0,0.902692437171936
112,tacticam,14,5,1296,304,1321,353,25,49,1308.5,328.5,0.9012407064437866
112,tacticam,15,11,884,220,910,262,26,42,897.0,241.0,0.8986722826957703
112,tacticam,4,20,957,261,984,302,27,41,970.5,281.5,0.8933358788490295
112,tacticam,12,19,697,325,722,370,25,45,709.5,347.5,0.8917313814163208
112,tacticam,7,29,1645,478,1675,532,30,54,1660.0,505.0,0.8909798264503479
113,broadcast,27,27,1554,533,1619,619,65,86,1586.5,576.0,0.9302663803100586
113,broadcast,2,2,1576,740,1657,868,81,128,1616.5,804.0,0.9241222739219666
113,broadcast,14,14,1496,586,1554,700,58,114,1525.0,643.0,0.9204050302505493
113,broadcast,9,9,1094,631,1142,744,48,113,1118.0,687.5,0.9186312556266785
113,broadcast,22,22,1685,539,1733,648,48,109,1709.0,593.5,0.901923656463623
113,broadcast,5,5,1684,637,1754,741,70,104,1719.0,689.0,0.8977384567260742
113,broadcast,20,20,1776,549,1805,656,29,107,1790.5,602.5,0.8777515888214111
113,broadcast,17,17,1884,546,1920,656,36,110,1902.0,601.0,0.8704020977020264
113,broadcast,29,29,1738,598,1766,695,28,97,1752.0,646.5,0.7989171147346497
113,tacticam,3,12,936,435,972,483,36,48,954.0,459.0,0.9250173568725586
113,tacticam,10,3,328,454,359,505,31,51,343.5,479.5,0.9240030646324158
113,tacticam,8,8,1394,698,1433,761,39,63,1413.5,729.5,0.921500027179718
113,tacticam,17,31,571,241,601,281,30,40,586.0,261.0,0.920195996761322
113,tacticam,2,15,1803,387,1835,441,32,54,1819.0,414.0,0.9196439981460571
113,tacticam,6,22,1273,386,1304,433,31,47,1288.5,409.5,0.9131647348403931
113,tacticam,12,19,693,323,723,372,30,49,708.0,347.5,0.9126858711242676
113,tacticam,11,14,460,306,488,350,28,44,474.0,328.0,0.906917929649353
113,tacticam,14,5,1295,305,1322,355,27,50,1308.5,330.0,0.9021152257919312
113,tacticam,7,29,1645,480,1668,535,23,55,1656.5,507.5,0.8914907574653625
113,tacticam,15,11,882,220,908,264,26,44,895.0,242.0,0.888010561466217
113,tacticam,20,17,642,240,666,284,24,44,654.0,262.0,0.8825343251228333
113,tacticam,13,10,894,320,917,365,23,45,905.5,342.5,0.8498795032501221
113,tacticam,19,27,646,215,671,262,25,47,658.5,238.5,0.7229018211364746
114,broadcast,2,2,1584,740,1657,869,73,129,1620.5,804.5,0.9333784580230713
114,broadcast,14,14,1501,591,1558,702,57,111,1529.5,646.5,0.9126490354537964
114,broadcast,9,9,1098,632,1147,747,49,115,1122.5,689.5,0.9112650752067566
114,broadcast,5,5,1684,636,1755,746,71,110,1719.5,691.0,0.89638352394104
114,broadcast,22,22,1693,540,1737,646,44,106,1715.0,593.0,0.8910449147224426
114,broadcast,20,20,1780,550,1809,657,29,107,1794.5,603.5,0.8861395120620728
114,broadcast,17,17,1884,548,1920,657,36,109,1902.0,602.5,0.8577154278755188
114,broadcast,29,29,1739,595,1773,711,34,116,1756.0,653.0,0.7679877877235413
114,tacticam,1,9,382,378,420,427,38,49,401.0,402.5,0.9267978668212891
114,tacticam,10,3,323,452,359,504,36,52,341.0,478.0,0.9243031740188599
114,tacticam,2,15,1802,387,1836,442,34,55,1819.0,414.5,0.9215638637542725
114,tacticam,12,19,687,324,720,369,33,45,703.5,346.5,0.9203127026557922
114,tacticam,8,8,1396,698,1432,759,36,61,1414.0,728.5,0.9166498184204102
114,tacticam,3,12,932,435,964,483,32,48,948.0,459.0,0.909530520439148
114,tacticam,6,22,1273,388,1300,434,27,46,1286.5,411.0,0.90604168176651
114,tacticam,14,5,1297,305,1323,355,26,50,1310.0,330.0,0.9017950892448425
114,tacticam,11,14,460,306,484,349,24,43,472.0,327.5,0.8949799537658691
114,tacticam,13,10,891,320,916,364,25,44,903.5,342.0,0.8894966244697571
114,tacticam,15,11,878,220,904,264,26,44,891.0,242.0,0.887877881526947
114,tacticam,7,29,1641,481,1663,535,22,54,1652.0,508.0,0.8766064047813416
114,tacticam,20,17,634,240,664,283,30,43,649.0,261.5,0.8610832691192627
114,tacticam,19,27,637,217,671,265,34,48,654.0,241.0,0.7262157201766968
115,broadcast,2,2,1589,740,1654,869,65,129,1621.5,804.5,0.9323195815086365
115,broadcast,5,5,1689,638,1752,748,63,110,1720.5,693.0,0.9092612862586975
115,broadcast,9,9,1102,635,1150,748,48,113,1126.0,691.5,0.9048013687133789
115,broadcast,14,14,1504,591,1559,703,55,112,1531.5,647.0,0.9039180278778076
115,broadcast,22,22,1700,540,1742,648,42,108,1721.0,594.0,0.8997548818588257
115,broadcast,27,27,1547,535,1612,618,65,83,1579.5,576.5,0.8763555884361267
115,broadcast,20,20,1782,548,1814,660,32,112,1798.0,604.0,0.8760648369789124
115,broadcast,17,17,1885,555,1920,658,35,103,1902.5,606.5,0.851210355758667
115,broadcast,29,29,1750,602,1781,712,31,110,1765.5,657.0,0.8004687428474426
115,tacticam,8,8,1396,697,1429,757,33,60,1412.5,727.0,0.928958535194397
115,tacticam,1,9,380,377,415,427,35,50,397.5,402.0,0.9219191670417786
115,tacticam,2,15,1803,387,1836,441,33,54,1819.5,414.0,0.9188305735588074
115,tacticam,13,10,889,318,915,363,26,45,902.0,340.5,0.9050355553627014
115,tacticam,10,3,319,447,356,499,37,52,337.5,473.0,0.9034758806228638
115,tacticam,6,22,1273,387,1296,433,23,46,1284.5,410.0,0.9027561545372009
115,tacticam,14,5,1296,304,1324,354,28,50,1310.0,329.0,0.9013577103614807
115,tacticam,5,2,655,464,688,514,33,50,671.5,489.0,0.9012537002563477
115,tacticam,7,29,1638,478,1661,533,23,55,1649.5,505.5,0.8865690231323242
115,tacticam,12,19,680,322,717,367,37,45,698.5,344.5,0.8824195861816406
115,tacticam,15,11,876,221,900,265,24,44,888.0,243.0,0.8725341558456421
115,tacticam,3,12,930,434,951,483,21,49,940.5,458.5,0.8585771918296814
115,tacticam,19,27,641,218,668,263,27,45,654.5,240.5,0.7091051936149597
116,broadcast,2,2,1593,741,1649,871,56,130,1621.0,806.0,0.934923529624939
116,broadcast,14,14,1505,592,1559,704,54,112,1532.0,648.0,0.8993496298789978
116,broadcast,5,5,1694,643,1746,750,52,107,1720.0,696.5,0.8978486657142639
116,broadcast,9,9,1104,636,1153,750,49,114,1128.5,693.0,0.896087646484375
116,broadcast,22,22,1706,541,1745,650,39,109,1725.5,595.5,0.8855059146881104
116,broadcast,20,20,1787,551,1820,661,33,110,1803.5,606.0,0.8773626089096069
116,broadcast,27,27,1555,538,1595,617,40,79,1575.0,577.5,0.8762641549110413
116,broadcast,17,17,1885,558,1919,658,34,100,1902.0,608.0,0.8491237163543701
116,broadcast,29,29,1756,595,1793,714,37,119,1774.5,654.5,0.8292552828788757
116,tacticam,2,15,1802,388,1837,442,35,54,1819.5,415.0,0.920627236366272
116,tacticam,8,8,1394,697,1423,757,29,60,1408.5,727.0,0.9191883206367493
116,tacticam,10,3,315,447,351,494,36,47,333.0,470.5,0.9158986806869507
116,tacticam,5,2,649,464,682,515,33,51,665.5,489.5,0.9154466986656189
116,tacticam,1,9,377,377,407,427,30,50,392.0,402.0,0.911408543586731
116,tacticam,14,5,1297,304,1323,355,26,51,1310.0,329.5,0.901118814945221
116,tacticam,17,31,561,239,588,281,27,42,574.5,260.0,0.8957551121711731
116,tacticam,7,29,1633,478,1661,534,28,56,1647.0,506.0,0.8951517939567566
116,tacticam,3,12,924,434,944,484,20,50,934.0,459.0,0.890252947807312
116,tacticam,13,10,888,318,912,363,24,45,900.0,340.5,0.8868107199668884
116,tacticam,19,27,636,220,661,266,25,46,648.5,243.0,0.7560775876045227
117,broadcast,2,2,1594,741,1647,873,53,132,1620.5,807.0,0.9160078763961792
117,broadcast,5,5,1700,646,1739,750,39,104,1719.5,698.0,0.8948829770088196
117,broadcast,14,14,1507,592,1557,704,50,112,1532.0,648.0,0.8940300345420837
117,broadcast,9,9,1104,637,1157,750,53,113,1130.5,693.5,0.88954758644104
117,broadcast,22,22,1711,541,1746,651,35,110,1728.5,596.0,0.8858245611190796
117,broadcast,27,27,1548,537,1581,620,33,83,1564.5,578.5,0.8855814337730408
117,broadcast,17,17,1881,554,1920,658,39,104,1900.5,606.0,0.865898847579956
117,broadcast,20,20,1787,554,1827,662,40,108,1807.0,608.0,0.8624666929244995
117,broadcast,29,29,1760,599,1795,716,35,117,1777.5,657.5,0.8147906064987183
117,tacticam,10,3,313,446,345,491,32,45,329.0,468.5,0.9212583303451538
117,tacticam,8,8,1392,697,1419,759,27,62,1405.5,728.0,0.9190836548805237
117,tacticam,2,15,1804,389,1839,444,35,55,1821.5,416.5,0.915381669998169
117,tacticam,7,29,1631,480,1661,534,30,54,1646.0,507.0,0.9127011299133301
117,tacticam,12,19,674,328,709,371,35,43,691.5,349.5,0.9121192097663879
117,tacticam,5,2,645,466,673,517,28,51,659.0,491.5,0.9044731855392456
117,tacticam,14,5,1299,305,1323,355,24,50,1311.0,330.0,0.9023828506469727
117,tacticam,3,12,919,434,943,485,24,51,931.0,459.5,0.899859607219696
117,tacticam,11,14,458,307,482,350,24,43,470.0,328.5,0.8981776237487793
117,tacticam,18,7,1568,298,1593,344,25,46,1580.5,321.0,0.894689679145813
117,tacticam,17,31,561,241,591,281,30,40,576.0,261.0,0.8882201910018921
117,tacticam,1,9,375,378,401,426,26,48,388.0,402.0,0.8766505122184753
117,tacticam,19,27,632,222,655,269,23,47,643.5,245.5,0.7745359539985657
118,broadcast,27,27,1537,535,1571,621,34,86,1554.0,578.0,0.9178903102874756
118,broadcast,2,2,1592,742,1646,874,54,132,1619.0,808.0,0.916676938533783
118,broadcast,9,9,1103,638,1157,750,54,112,1130.0,694.0,0.8961623907089233
118,broadcast,14,14,1517,592,1554,704,37,112,1535.5,648.0,0.8938166499137878
118,broadcast,22,22,1713,541,1745,645,32,104,1729.0,593.0,0.8712488412857056
118,broadcast,17,17,1881,561,1920,661,39,100,1900.5,611.0,0.8632020354270935
118,broadcast,5,5,1704,638,1737,753,33,115,1720.5,695.5,0.8429633378982544
118,broadcast,29,29,1769,599,1803,718,34,119,1786.0,658.5,0.801397979259491
118,broadcast,20,20,1791,566,1831,664,40,98,1811.0,615.0,0.7635682225227356
118,tacticam,8,8,1389,694,1415,757,26,63,1402.0,725.5,0.9173135757446289
118,tacticam,7,29,1625,478,1659,533,34,55,1642.0,505.5,0.9164121747016907
118,tacticam,2,15,1804,389,1838,443,34,54,1821.0,416.0,0.9161272644996643
118,tacticam,3,12,912,432,939,482,27,50,925.5,457.0,0.9151071906089783
118,tacticam,10,3,309,444,337,490,28,46,323.0,467.0,0.9128932356834412
118,tacticam,5,2,642,463,667,515,25,52,654.5,489.0,0.9083662629127502
118,tacticam,11,14,457,306,483,349,26,43,470.0,327.5,0.9040015935897827
118,tacticam,18,7,1568,299,1593,345,25,46,1580.5,322.0,0.9010698795318604
118,tacticam,14,5,1300,305,1322,355,22,50,1311.0,330.0,0.9003587961196899
118,tacticam,12,19,672,327,702,370,30,43,687.0,348.5,0.8902345299720764
118,tacticam,20,17,618,243,643,284,25,41,630.5,263.5,0.8660732507705688
118,tacticam,4,20,946,261,969,307,23,46,957.5,284.0,0.8222745060920715
119,broadcast,2,2,1590,741,1649,875,59,134,1619.5,808.0,0.9156615734100342
119,broadcast,27,27,1529,534,1567,620,38,86,1548.0,577.0,0.9073643684387207
119,broadcast,9,9,1103,638,1154,752,51,114,1128.5,695.0,0.8977295160293579
119,broadcast,14,14,1516,592,1553,705,37,113,1534.5,648.5,0.887471079826355
119,broadcast,20,20,1796,554,1835,660,39,106,1815.5,607.0,0.887176513671875
119,broadcast,22,22,1718,542,1746,641,28,99,1732.0,591.5,0.875636100769043
119,broadcast,29,29,1774,602,1807,719,33,117,1790.5,660.5,0.8661592602729797
119,broadcast,17,17,1884,566,1920,662,36,96,1902.0,614.0,0.861356258392334
119,broadcast,5,5,1704,644,1739,753,35,109,1721.5,698.5,0.8247052431106567
119,broadcast,28,28,871,691,899,750,28,59,885.0,720.5,0.7005481123924255
119,tacticam,2,15,1805,388,1835,442,30,54,1820.0,415.0,0.9288579225540161
119,tacticam,3,12,905,431,936,480,31,49,920.5,455.5,0.9230177998542786
119,tacticam,17,31,552,239,584,280,32,41,568.0,259.5,0.9228734970092773
119,tacticam,5,2,637,462,665,514,28,52,651.0,488.0,0.9190942049026489
119,tacticam,7,29,1617,478,1657,530,40,52,1637.0,504.0,0.917322039604187
119,tacticam,10,3,304,441,328,489,24,48,316.0,465.0,0.913405179977417
119,tacticam,11,14,452,306,482,348,30,42,467.0,327.0,0.9108172059059143
119,tacticam,8,8,1387,691,1413,757,26,66,1400.0,724.0,0.9100627303123474
119,tacticam,4,20,941,261,969,305,28,44,955.0,283.0,0.9073700308799744
119,tacticam,18,7,1567,299,1593,345,26,46,1580.0,322.0,0.8969278931617737
119,tacticam,1,9,367,375,388,424,21,49,377.5,399.5,0.8860870003700256
119,tacticam,6,22,1264,386,1285,434,21,48,1274.5,410.0,0.8804023861885071
119,tacticam,19,27,623,218,653,259,30,41,638.0,238.5,0.8693017363548279
119,tacticam,15,11,840,210,865,251,25,41,852.5,230.5,0.8531776070594788
120,broadcast,2,2,1588,743,1649,879,61,136,1618.5,811.0,0.9184583425521851
120,broadcast,27,27,1518,533,1566,621,48,88,1542.0,577.0,0.8983714580535889
120,broadcast,9,9,1102,639,1153,754,51,115,1127.5,696.5,0.8981893658638
120,broadcast,22,22,1718,543,1747,644,29,101,1732.5,593.5,0.8869922757148743
120,broadcast,14,14,1514,590,1553,708,39,118,1533.5,649.0,0.8792786002159119
120,broadcast,29,29,1776,603,1810,720,34,117,1793.0,661.5,0.8621402382850647
120,broadcast,20,20,1800,558,1838,661,38,103,1819.0,609.5,0.8539907932281494
120,broadcast,17,17,1887,569,1920,665,33,96,1903.5,617.0,0.8437590599060059
120,broadcast,5,5,1701,645,1736,754,35,109,1718.5,699.5,0.8437281250953674
120,tacticam,17,31,548,240,580,281,32,41,564.0,260.5,0.9243292808532715
120,tacticam,2,15,1805,389,1832,442,27,53,1818.5,415.5,0.9242479205131531
120,tacticam,10,3,300,440,328,488,28,48,314.0,464.0,0.9227899312973022
120,tacticam,3,12,894,431,931,479,37,48,912.5,455.0,0.9174072742462158
120,tacticam,8,8,1385,690,1412,756,27,66,1398.5,723.0,0.9137013554573059
120,tacticam,7,29,1616,479,1654,531,38,52,1635.0,505.0,0.9113066792488098
120,tacticam,4,20,939,262,967,306,28,44,953.0,284.0,0.9086990356445312
120,tacticam,1,9,364,376,384,426,20,50,374.0,401.0,0.9084932804107666
120,tacticam,5,2,631,462,663,513,32,51,647.0,487.5,0.9058624505996704
120,tacticam,11,14,449,307,483,348,34,41,466.0,327.5,0.9031602144241333
120,tacticam,6,22,1261,386,1285,434,24,48,1273.0,410.0,0.8927390575408936
121,broadcast,2,2,1579,745,1648,882,69,137,1613.5,813.5,0.9216128587722778
121,broadcast,27,27,1498,538,1560,618,62,80,1529.0,578.0,0.9056059718132019
121,broadcast,9,9,1104,639,1153,754,49,115,1128.5,696.5,0.8969895839691162
121,broadcast,14,14,1514,591,1553,710,39,119,1533.5,650.5,0.8924290537834167
121,broadcast,29,29,1780,602,1815,721,35,119,1797.5,661.5,0.8817314505577087
121,broadcast,5,5,1694,642,1735,756,41,114,1714.5,699.0,0.8716100454330444
121,broadcast,17,17,1890,569,1920,666,30,97,1905.0,617.5,0.8454041481018066
121,broadcast,22,22,1797,557,1828,631,31,74,1812.5,594.0,0.8422958254814148
121,broadcast,20,20,1800,595,1839,666,39,71,1819.5,630.5,0.7768239378929138
121,broadcast,30,30,1714,543,1749,643,35,100,1731.5,593.0,0.8775307536125183
121,tacticam,3,12,890,430,922,480,32,50,906.0,455.0,0.9281527400016785
121,tacticam,5,2,622,462,659,512,37,50,640.5,487.0,0.9279588460922241
121,tacticam,8,8,1382,689,1412,756,30,67,1397.0,722.5,0.9226696491241455
121,tacticam,17,31,543,240,573,282,30,42,558.0,261.0,0.9155354499816895
121,tacticam,2,15,1807,389,1829,442,22,53,1818.0,415.5,0.9149770140647888
121,tacticam,10,3,296,437,327,487,31,50,311.5,462.0,0.9062175154685974
121,tacticam,6,22,1257,386,1285,434,28,48,1271.0,410.0,0.9046456217765808
121,tacticam,4,20,939,265,966,307,27,42,952.5,286.0,0.9024286866188049
121,tacticam,7,29,1617,480,1647,532,30,52,1632.0,506.0,0.8845389485359192
122,broadcast,2,2,1569,746,1645,882,76,136,1607.0,814.0,0.9318355321884155
122,broadcast,14,14,1509,591,1552,711,43,120,1530.5,651.0,0.9047444462776184
122,broadcast,9,9,1103,638,1151,754,48,116,1127.0,696.0,0.8978977799415588
122,broadcast,27,27,1492,537,1540,618,48,81,1516.0,577.5,0.8936720490455627
122,broadcast,5,5,1689,633,1739,756,50,123,1714.0,694.5,0.8920843601226807
122,broadcast,29,29,1781,604,1827,721,46,117,1804.0,662.5,0.8777800798416138
122,broadcast,30,30,1710,543,1749,645,39,102,1729.5,594.0,0.8758934736251831
122,broadcast,20,20,1796,559,1828,628,32,69,1812.0,593.5,0.8433791995048523
122,broadcast,17,17,1895,568,1920,667,25,99,1907.5,617.5,0.8430296778678894
122,tacticam,10,3,292,434,324,484,32,50,308.0,459.0,0.9285904169082642
122,tacticam,8,8,1379,688,1411,754,32,66,1395.0,721.0,0.9261071085929871
122,tacticam,6,22,1253,387,1285,434,32,47,1269.0,410.5,0.9232814311981201
122,tacticam,12,19,652,321,681,368,29,47,666.5,344.5,0.9190345406532288
122,tacticam,5,2,617,461,654,511,37,50,635.5,486.0,0.9160879254341125
122,tacticam,2,15,1807,388,1827,442,20,54,1817.0,415.0,0.9097852110862732
122,tacticam,1,9,353,377,378,424,25,47,365.5,400.5,0.9056459665298462
122,tacticam,15,11,861,218,886,262,25,44,873.5,240.0,0.9039270281791687
122,tacticam,7,29,1617,479,1642,531,25,52,1629.5,505.0,0.9018006920814514
122,tacticam,3,12,891,430,912,479,21,49,901.5,454.5,0.8996867537498474
122,tacticam,4,20,940,264,964,307,24,43,952.0,285.5,0.8974014520645142
122,tacticam,20,17,596,239,623,279,27,40,609.5,259.0,0.8770960569381714
122,tacticam,13,10,876,313,901,360,25,47,888.5,336.5,0.8670172095298767
122,tacticam,9,21,439,288,465,328,26,40,452.0,308.0,0.8487957119941711
123,broadcast,2,2,1566,749,1644,883,78,134,1605.0,816.0,0.9387006163597107
123,broadcast,5,5,1682,634,1737,758,55,124,1709.5,696.0,0.9100750684738159
123,broadcast,14,14,1508,593,1552,712,44,119,1530.0,652.5,0.9063453674316406
123,broadcast,9,9,1103,639,1153,757,50,118,1128.0,698.0,0.9052935838699341
123,broadcast,29,29,1782,606,1835,724,53,118,1808.5,665.0,0.8792414665222168
123,broadcast,30,30,1715,544,1751,653,36,109,1733.0,598.5,0.8755826354026794
123,broadcast,27,27,1493,537,1534,618,41,81,1513.5,577.5,0.8753019571304321
123,broadcast,17,17,1898,566,1920,667,22,101,1909.0,616.5,0.8480467796325684
123,broadcast,20,20,1797,558,1833,654,36,96,1815.0,606.0,0.7914503812789917
123,tacticam,10,3,287,433,321,479,34,46,304.0,456.0,0.9340671896934509
123,tacticam,8,8,1378,688,1409,753,31,65,1393.5,720.5,0.9246857762336731
123,tacticam,6,22,1254,388,1282,435,28,47,1268.0,411.5,0.9210904240608215
123,tacticam,1,9,346,377,378,424,32,47,362.0,400.5,0.9168035984039307
123,tacticam,5,2,613,461,643,512,30,51,628.0,486.5,0.9157928824424744
123,tacticam,12,19,647,324,679,365,32,41,663.0,344.5,0.9044894576072693
123,tacticam,13,10,874,313,899,359,25,46,886.5,336.0,0.8902734518051147
123,tacticam,7,29,1615,478,1635,532,20,54,1625.0,505.0,0.8870127201080322
123,tacticam,11,14,446,302,484,348,38,46,465.0,325.0,0.8827217221260071
123,tacticam,15,11,861,215,884,262,23,47,872.5,238.5,0.879030168056488
123,tacticam,9,21,440,287,467,329,27,42,453.5,308.0,0.8339837193489075
124,broadcast,2,2,1564,752,1640,886,76,134,1602.0,819.0,0.93889981508255
124,broadcast,14,14,1507,594,1553,713,46,119,1530.0,653.5,0.9117977619171143
124,broadcast,5,5,1677,637,1735,760,58,123,1706.0,698.5,0.9083379507064819
124,broadcast,9,9,1102,640,1146,758,44,118,1124.0,699.0,0.9054273962974548
124,broadcast,30,30,1710,545,1752,657,42,112,1731.0,601.0,0.8781620860099792
124,broadcast,29,29,1780,602,1834,724,54,122,1807.0,663.0,0.876200258731842
124,broadcast,27,27,1491,535,1528,621,37,86,1509.5,578.0,0.8443017601966858
124,broadcast,20,20,1795,560,1829,631,34,71,1812.0,595.5,0.7866795063018799
124,tacticam,1,9,341,376,380,423,39,47,360.5,399.5,0.9224495887756348
124,tacticam,10,3,283,431,315,477,32,46,299.0,454.0,0.921416699886322
124,tacticam,8,8,1380,688,1408,751,28,63,1394.0,719.5,0.9179254770278931
124,tacticam,2,15,1805,388,1825,443,20,55,1815.0,415.5,0.9079227447509766
124,tacticam,14,5,1295,304,1316,355,21,51,1305.5,329.5,0.9031093716621399
124,tacticam,3,12,876,428,900,478,24,50,888.0,453.0,0.8966609835624695
124,tacticam,7,29,1611,478,1632,532,21,54,1621.5,505.0,0.8965533971786499
124,tacticam,5,2,614,461,639,511,25,50,626.5,486.0,0.8952267169952393
124,tacticam,6,22,1255,389,1278,435,23,46,1266.5,412.0,0.8942674398422241
124,tacticam,15,11,859,216,883,263,24,47,871.0,239.5,0.8757895231246948
124,tacticam,11,14,446,300,483,347,37,47,464.5,323.5,0.8738314509391785
124,tacticam,20,17,587,239,622,282,35,43,604.5,260.5,0.8581554889678955
124,tacticam,9,21,442,286,468,329,26,43,455.0,307.5,0.7748913764953613
124,tacticam,26,36,819,209,846,250,27,41,832.5,229.5,0.8920734524726868
125,broadcast,2,2,1562,752,1637,888,75,136,1599.5,820.0,0.9261117577552795
125,broadcast,5,5,1672,641,1735,763,63,122,1703.5,702.0,0.9151219129562378
125,broadcast,14,14,1507,597,1555,715,48,118,1531.0,656.0,0.9113132357597351
125,broadcast,9,9,1103,640,1153,760,50,120,1128.0,700.0,0.9041977524757385
125,broadcast,27,27,1482,535,1521,620,39,85,1501.5,577.5,0.8874804377555847
125,broadcast,30,30,1712,545,1753,658,41,113,1732.5,601.5,0.8860511779785156
125,broadcast,29,29,1783,607,1832,725,49,118,1807.5,666.0,0.8647176027297974
125,broadcast,20,20,1796,560,1835,622,39,62,1815.5,591.0,0.8158378601074219
125,broadcast,28,28,873,698,904,751,31,53,888.5,724.5,0.6787640452384949
125,tacticam,10,3,281,428,309,476,28,48,295.0,452.0,0.9177030324935913
125,tacticam,3,12,872,427,901,475,29,48,886.5,451.0,0.9110011458396912
125,tacticam,2,15,1805,389,1826,442,21,53,1815.5,415.5,0.910578191280365
125,tacticam,14,5,1294,305,1318,355,24,50,1306.0,330.0,0.9046339988708496
125,tacticam,18,7,1559,297,1585,344,26,47,1572.0,320.5,0.9027175903320312
125,tacticam,7,29,1609,475,1633,532,24,57,1621.0,503.5,0.901383101940155
125,tacticam,26,36,814,209,843,250,29,41,828.5,229.5,0.8973473906517029
125,tacticam,11,14,447,290,480,347,33,57,463.5,318.5,0.8972249031066895
125,tacticam,12,19,642,323,669,363,27,40,655.5,343.0,0.888913094997406
125,tacticam,8,8,1380,688,1405,750,25,62,1392.5,719.0,0.8699607849121094
125,tacticam,5,2,612,457,633,513,21,56,622.5,485.0,0.7871020436286926
125,tacticam,20,17,600,240,623,284,23,44,611.5,262.0,0.7825320363044739
125,tacticam,19,27,605,227,629,271,24,44,617.0,249.0,0.7333436012268066
126,tacticam,3,12,866,426,899,474,33,48,882.5,450.0,0.9208247065544128
126,tacticam,10,3,278,427,307,476,29,49,292.5,451.5,0.9186546802520752
126,tacticam,1,9,340,375,379,424,39,49,359.5,399.5,0.9171696901321411
126,tacticam,2,15,1802,389,1827,444,25,55,1814.5,416.5,0.9167761206626892
126,tacticam,7,29,1606,475,1634,530,28,55,1620.0,502.5,0.9136345982551575
126,tacticam,18,7,1557,297,1584,343,27,46,1570.5,320.0,0.9066723585128784
126,tacticam,14,5,1295,305,1321,355,26,50,1308.0,330.0,0.9062879085540771
126,tacticam,5,2,608,460,631,511,23,51,619.5,485.5,0.8978031873703003
126,tacticam,26,36,811,210,841,251,30,41,826.0,230.5,0.8964448571205139
126,tacticam,11,14,449,296,480,347,31,51,464.5,321.5,0.8623830080032349
127,tacticam,1,9,341,375,372,423,31,48,356.5,399.0,0.9309642314910889
127,tacticam,7,29,1602,475,1635,529,33,54,1618.5,502.0,0.9204260110855103
127,tacticam,2,15,1801,390,1829,444,28,54,1815.0,417.0,0.9187796711921692
127,tacticam,10,3,274,425,307,475,33,50,290.5,450.0,0.912634015083313
127,tacticam,5,2,603,460,631,511,28,51,617.0,485.5,0.91237872838974
127,tacticam,3,12,861,427,896,474,35,47,878.5,450.5,0.9123042225837708
127,tacticam,18,7,1556,298,1586,344,30,46,1571.0,321.0,0.908517062664032
127,tacticam,14,5,1295,306,1322,355,27,49,1308.5,330.5,0.9042187333106995
127,tacticam,26,36,807,211,836,252,29,41,821.5,231.5,0.8891363739967346
127,tacticam,11,14,450,297,474,346,24,49,462.0,321.5,0.8415244221687317
127,tacticam,19,27,579,241,611,286,32,45,595.0,263.5,0.7702271938323975
128,tacticam,5,2,600,457,631,510,31,53,615.5,483.5,0.9223223924636841
128,tacticam,7,29,1599,475,1636,529,37,54,1617.5,502.0,0.9211853742599487
128,tacticam,2,15,1804,390,1832,444,28,54,1818.0,417.0,0.9187659621238708
128,tacticam,3,12,855,426,893,474,38,48,874.0,450.0,0.9138669967651367
128,tacticam,14,5,1297,306,1325,355,28,49,1311.0,330.5,0.9088363647460938
128,tacticam,18,7,1559,298,1589,345,30,47,1574.0,321.5,0.9071226716041565
128,tacticam,1,9,341,374,364,423,23,49,352.5,398.5,0.9046065211296082
128,tacticam,10,3,272,423,304,472,32,49,288.0,447.5,0.9030938148498535
128,tacticam,11,14,451,293,472,345,21,52,461.5,319.0,0.8304810523986816
128,tacticam,19,27,578,240,608,284,30,44,593.0,262.0,0.8253008723258972
129,tacticam,5,2,594,456,631,508,37,52,612.5,482.0,0.9261002540588379
129,tacticam,10,3,270,421,300,467,30,46,285.0,444.0,0.9254356622695923
129,tacticam,2,15,1806,390,1835,443,29,53,1820.5,416.5,0.9236400723457336
129,tacticam,7,29,1598,475,1636,529,38,54,1617.0,502.0,0.9231125712394714
129,tacticam,14,5,1300,306,1327,355,27,49,1313.5,330.5,0.9136207699775696
129,tacticam,3,12,853,425,888,475,35,50,870.5,450.0,0.9118263125419617
129,tacticam,6,22,1255,386,1276,435,21,49,1265.5,410.5,0.901864230632782
129,tacticam,4,20,938,261,962,306,24,45,950.0,283.5,0.9017389416694641
129,tacticam,18,7,1562,299,1589,344,27,45,1575.5,321.5,0.8986323475837708
129,tacticam,11,14,451,297,473,343,22,46,462.0,320.0,0.8340166807174683
129,tacticam,8,8,1379,682,1402,747,23,65,1390.5,714.5,0.7883861660957336
129,tacticam,9,21,456,285,479,333,23,48,467.5,309.0,0.7743910551071167
129,tacticam,27,37,194,311,218,359,24,48,206.0,335.0,0.7563074231147766
130,tacticam,2,15,1805,391,1837,445,32,54,1821.0,418.0,0.9234511256217957
130,tacticam,7,29,1601,477,1633,529,32,52,1617.0,503.0,0.9166216850280762
130,tacticam,10,3,267,421,293,467,26,46,280.0,444.0,0.9147809147834778
130,tacticam,8,8,1376,682,1403,747,27,65,1389.5,714.5,0.9132673144340515
130,tacticam,1,9,338,374,360,422,22,48,349.0,398.0,0.91301029920578
130,tacticam,13,10,870,307,894,351,24,44,882.0,329.0,0.9129060506820679
130,tacticam,14,5,1303,308,1328,355,25,47,1315.5,331.5,0.9128565788269043
130,tacticam,6,22,1252,387,1277,436,25,49,1264.5,411.5,0.909935712814331
130,tacticam,4,20,938,262,965,308,27,46,951.5,285.0,0.904677152633667
130,tacticam,20,17,613,224,638,264,25,40,625.5,244.0,0.8970491290092468
130,tacticam,18,7,1566,298,1588,344,22,46,1577.0,321.0,0.8902102708816528
130,tacticam,3,12,854,425,880,475,26,50,867.0,450.0,0.889915406703949
130,tacticam,11,14,452,294,473,343,21,49,462.5,318.5,0.8411814570426941
130,tacticam,27,37,197,316,221,360,24,44,209.0,338.0,0.7853941321372986
131,tacticam,6,22,1249,387,1280,435,31,48,1264.5,411.0,0.9185560345649719
131,tacticam,13,10,870,307,895,351,25,44,882.5,329.0,0.9175207018852234
131,tacticam,20,17,614,223,643,264,29,41,628.5,243.5,0.9163348078727722
131,tacticam,8,8,1375,682,1406,745,31,63,1390.5,713.5,0.9118641018867493
131,tacticam,1,9,336,374,358,423,22,49,347.0,398.5,0.9102305173873901
131,tacticam,7,29,1603,477,1631,529,28,52,1617.0,503.0,0.9100744724273682
131,tacticam,4,20,941,262,965,307,24,45,953.0,284.5,0.9088351130485535
131,tacticam,2,15,1808,391,1839,445,31,54,1823.5,418.0,0.9052959680557251
131,tacticam,14,5,1306,307,1330,355,24,48,1318.0,331.0,0.8975757956504822
